strap,tax_yr,bld_appraised_val,land_appraised_val,total_appraised_val,bld_assessed_val,land_assessed_val,total_assessed_val
R0000008,2024,242500,874000,1116500,16248.0,,71121
R0000019,2024,268200,757100,1025300,17969.0,,65010
R0000021,2024,991300,1053600,2044900,66418.0,,133323
R0000024,2024,531300,797000,1328300,31912.0,,85311
R0000026,2024,1051300,1238700,2290000,70437.0,,149745
R0000027,2024,1172100,814400,1986500,78531.0,,129411
R0000028,2024,448600,2658300,3106900,30056.0,,204477
R0000031,2024,847700,885800,1733500,56796.0,,112460
R0000032,2024,1997900,990500,2988400,133859.0,,196538
R0000034,2024,478100,1049300,1527400,32033.0,,98651
R0000036,2024,2038500,1422200,3460700,136580.0,,228182
R0000037,2024,237000,857000,1094000,15879.0,,69613
R0000038,2024,146800,742700,889500,9836.0,,55912
R0000047,2024,398100,962900,1361000,26673.0,,87502
R0000048,2024,775300,656900,1432200,51945.0,,92272
R0000049,2024,504380,694800,1199180,33793.0,,76660
R0000052,2024,653800,2467800,3121600,43805.0,,205462
R0000086,2024,684700,902900,1587600,45875.0,,102684
R0000087,2024,498100,880200,1378300,33373.0,,88661
R0000089,2024,280500,2524500,2805000,18794.0,,184250
R0000094,2024,224700,693200,917900,15055.0,,57814
R0000097,2024,358600,850300,1208900,20341.0,,77311
R0000100,2024,133700,1172400,1306100,8958.0,,83824
R0000102,2024,858500,1083300,1941800,57520.0,,126416
R0000105,2024,2887800,1582000,4469800,193482.0,,295792
R0000106,2024,1279800,1115900,2395700,85746.0,,156827
R0000109,2024,267000,1542500,1809500,17889.0,,117552
R0000110,2024,299070,2691630,2990700,20038.0,,196692
R0000117,2024,954900,939400,1894300,63978.0,,123233
R0000118,2024,1078300,1400400,2478700,72246.0,,162388
R0000119,2024,774600,918500,1693100,51898.0,,109753
R0000121,2024,375200,775100,1150300,25138.0,,73385
R0000122,2024,3623600,2967900,6591500,242781.0,,437946
R0000125,2024,178900,1641100,1820000,11986.0,,118255
R0000135,2024,777200,848100,1625300,52072.0,,105210
R0000136,2024,781700,1192900,1974600,52374.0,,128613
R0000139,2024,872400,1901300,2773700,58451.0,,182153
R0000141,2024,461400,692000,1153400,27229.0,,73593
R0000146,2024,952000,836900,1788900,63784.0,,116171
R0000149,2024,1409500,1232100,2641600,94437.0,,173302
R0000166,2024,555900,960600,1516500,37245.0,,97921
R0000168,2024,345700,1473000,1818700,23162.0,,118168
R0000169,2024,1721400,2354800,4076200,115334.0,,269420
R0000173,2024,120480,1084320,1204800,8072.0,,77037
R0000177,2024,601400,683700,1285100,40294.0,,82417
R0000183,2024,515200,772700,1287900,30833.0,,82604
R0000185,2024,168800,858100,1026900,11310.0,,65117
R0000191,2024,441100,1036200,1477300,29554.0,,95294
R0000198,2024,493200,517500,1010700,33044.0,,64032
R0000200,2024,241700,855500,1097200,16194.0,,69827
R0000201,2024,1688400,1629900,3318300,113123.0,,218641
R0000208,2024,296100,514800,810900,19839.0,,50645
R0000215,2024,808600,822900,1631500,54176.0,,105626
R0000216,2024,433600,737900,1171500,29051.0,,74806
R0000217,2024,285900,1202700,1488600,19155.0,,96051
R0000218,2024,654600,641300,1295900,43858.0,,83140
R0000224,2024,662000,753800,1415800,44354.0,,91174
R0000225,2024,389100,556300,945400,26070.0,,59657
R0000226,2024,657300,814500,1471800,44039.0,,94926
R0000227,2024,184600,610400,795000,12368.0,,49580
R0000238,2024,878400,928000,1806400,58853.0,,117344
R0000241,2024,1661700,1057700,2719400,111334.0,,178515
R0000242,2024,312800,906000,1218800,20958.0,,77975
R0000244,2024,1027500,941700,1969200,68843.0,,128251
R0000249,2024,234975,1713500,1948475,15743.0,,126863
R0000250,2024,1548900,1409700,2958600,103776.0,,194541
R0000252,2024,177400,955500,1132900,11886.0,,72219
R0000253,2024,1275500,1642600,2918100,85459.0,,191828
R0000254,2024,1946700,1990100,3936800,130429.0,,260081
R0000255,2024,1030200,535000,1565200,69023.0,,101183
R0000256,2024,1333400,1379100,2712500,89337.0,,178053
R0000258,2024,470600,834200,1304800,31530.0,,83737
R0000261,2024,600000,1470100,2070100,40200.0,,135012
R0000264,2024,222800,630600,853400,14928.0,,53493
R0000269,2024,2004800,2186900,4191700,134322.0,,277159
R0000282,2024,297000,1295300,1592300,19899.0,,102999
R0000286,2024,1042700,1845900,2888600,69861.0,,189851
R0000300,2024,782300,1037400,1819700,52414.0,,118235
R0000305,2024,679800,1716300,2396100,45547.0,,156854
R0000307,2024,278800,1345000,1623800,18680.0,,105110
R0000309,2024,699000,426600,1125600,46833.0,,71730
R0000310,2024,481200,1072500,1553700,32240.0,,100413
R0000311,2024,699100,830200,1529300,46840.0,,98778
R0000314,2024,114680,1032120,1146800,7684.0,,73151
R0000315,2024,463900,1230800,1694700,31081.0,,109860
R0000319,2024,549300,899100,1448400,36803.0,,93358
R0000324,2024,138200,1243800,1382000,9259.0,,88909
R0000328,2024,1256400,849900,2106300,84179.0,,137437
R0000334,2024,955200,841400,1796600,63998.0,,116687
R0000337,2024,339200,1395000,1734200,22726.0,,112506
R0000340,2024,895200,891800,1787000,59978.0,,116044
R0000344,2024,1172100,1027900,2200000,78531.0,,143715
R0000345,2024,188800,934400,1123200,12650.0,,71569
R0000347,2024,415300,1115100,1530400,27825.0,,98852
R0000348,2024,269190,2422710,2691900,18036.0,,176672
R0000351,2024,1940000,1591300,3531300,129980.0,,232912
R0000354,2024,545800,1496000,2041800,36569.0,,133116
R0000358,2024,2448400,2810900,5259300,164043.0,,348688
R0000360,2024,666000,942600,1608600,44622.0,,104091
R0000361,2024,100490,904410,1004900,6733.0,,63643
R0000365,2024,2256400,1755500,4011900,151179.0,,265112
R0000366,2024,426300,639500,1065800,24877.0,,67724
R0000367,2024,271700,984600,1256300,18204.0,,80487
R0000369,2024,159000,832100,991100,10653.0,,62719
R0000373,2024,1199500,1048700,2248200,80367.0,,146944
R0000376,2024,710200,912800,1623000,47583.0,,105056
R0000377,2024,274800,1380800,1655600,18411.0,,107240
R0000378,2024,1127300,1636600,2763900,75529.0,,181496
R0000383,2024,766800,554700,1321500,51376.0,,84856
R0000390,2024,1383600,1138000,2521600,92701.0,,165262
R0000391,2024,1411100,2159300,3570400,94544.0,,235532
R0000394,2024,1253900,1487900,2741800,84011.0,,180016
R0000398,2024,516600,1478400,1995000,34613.0,,129980
R0000401,2024,683200,1523200,2206400,45774.0,,144144
R0000403,2024,365200,1122600,1487800,24468.0,,95998
R0000405,2024,155299,575600,730899,10405.0,,45285
R0000407,2024,279600,954300,1233900,18733.0,,78986
R0000408,2024,96640,869760,966400,6475.0,,61064
R0000410,2024,1200500,1024800,2225300,80434.0,,145410
R0000413,2024,289700,890600,1180300,19410.0,,75395
R0000416,2024,681800,1104400,1786200,45681.0,,115990
R0000417,2024,556500,1027900,1584400,37286.0,,102470
R0000423,2024,935900,826000,1761900,62705.0,,114362
R0000426,2024,231340,2082060,2313400,15500.0,,151313
R0000428,2024,830100,1016900,1847000,55617.0,,120064
R0000429,2024,1594200,2093800,3688000,106811.0,,243411
R0000432,2024,200500,1045300,1245800,13434.0,,79784
R0000434,2024,475000,865000,1340000,28140.0,,86095
R0000441,2024,1203500,1418400,2621900,80635.0,,171982
R0000442,2024,717600,1002200,1719800,48079.0,,111542
R0000445,2024,3910800,2078500,5989300,262024.0,,397598
R0000448,2024,2230400,1915100,4145500,149437.0,,274064
R0000449,2024,3166500,1967200,5133700,212156.0,,340273
R0000451,2024,1005000,1018100,2023100,67335.0,,131863
R0000452,2024,1891900,1439100,3331000,126758.0,,219492
R0000453,2024,2991900,1408000,4399900,200457.0,,291108
R0000454,2024,339200,687800,1027000,22726.0,,65124
R0000456,2024,120800,909600,1030400,8094.0,,65352
R0000457,2024,1208000,1219500,2427500,80936.0,,158958
R0000459,2024,2008400,3052300,5060700,134563.0,,335382
R0000464,2024,603200,2509900,3113100,40414.0,,204893
R0000466,2024,294600,1347100,1641700,19738.0,,106309
R0000467,2024,936548,1291700,2228248,62749.0,,145608
R0000474,2024,491900,1913600,2405500,32957.0,,157484
R0000476,2024,763600,1067400,1831000,51161.0,,118992
R0000478,2024,623100,1130500,1753600,41748.0,,113806
R0000479,2024,347300,884700,1232000,23269.0,,78859
R0000481,2024,371800,1196200,1568000,24911.0,,101371
R0000483,2024,464000,999200,1463200,31088.0,,94349
R0000484,2024,127890,1151010,1278900,8569.0,,82001
R0000486,2024,213800,1924200,2138000,14325.0,,139561
R0000488,2024,1172900,879300,2052200,78584.0,,133812
R0000495,2024,652200,344800,997000,40012.0,,63114
R0000502,2024,632400,834000,1466400,42371.0,,94564
R0000505,2024,774600,551200,1325800,51898.0,,85144
R0000507,2024,145610,1310490,1456100,9756.0,,93874
R0000510,2024,3023500,1273700,4297200,202575.0,,284227
R0000513,2024,1561200,916900,2478100,104600.0,,162348
R0000515,2024,1335800,1016600,2352400,89499.0,,153926
R0000516,2024,637000,854200,1491200,42679.0,,96225
R0000517,2024,774700,940200,1714900,51905.0,,111213
R0000522,2024,305000,952400,1257400,20435.0,,80561
R0000523,2024,1532600,1104300,2636900,102684.0,,172987
R0000537,2024,321100,2681500,3002600,21514.0,,197489
R0000538,2024,662200,673300,1335500,44367.0,,85794
R0000541,2024,881200,1829800,2711000,59040.0,,177952
R0000544,2024,478000,841900,1319900,32026.0,,84748
R0000545,2024,1014100,1434400,2448500,67945.0,,160365
R0000546,2024,830700,1107300,1938000,55657.0,,126161
R0000548,2024,264600,976300,1240900,17728.0,,79455
R0000549,2024,300300,876000,1176300,20120.0,,75127
R0000552,2024,581100,1212100,1793200,38934.0,,116459
R0000555,2024,872800,1060600,1933400,58478.0,,125853
R0000559,2024,1149900,1809700,2959600,77043.0,,194608
R0000562,2024,251900,1665400,1917300,16877.0,,124774
R0000566,2024,185500,1047800,1233300,12429.0,,78946
R0000567,2024,443900,848100,1292000,29741.0,,82879
R0000568,2024,141260,1271340,1412600,9464.0,,90959
R0000571,2024,768500,1620400,2388900,51490.0,,156371
R0000574,2024,368700,877100,1245800,24703.0,,79784
R0000576,2024,483900,834800,1318700,32421.0,,84668
R0000579,2024,724100,975700,1699800,48515.0,,110202
R0000581,2024,1317100,1042900,2360000,88246.0,,154435
R0000582,2024,581800,838300,1420100,38981.0,,91462
R0000583,2024,3839500,2315600,6155100,257247.0,,408707
R0000587,2024,444900,833400,1278300,29808.0,,81961
R0000588,2024,1694300,858000,2552300,113518.0,,167319
R0000594,2024,818300,653000,1471300,54826.0,,94892
R0000596,2024,564600,1901000,2465600,37828.0,,161510
R0000597,2024,1059500,883300,1942800,70987.0,,126483
R0000605,2024,750000,827700,1577700,50250.0,,102021
R0000606,2024,288500,1587000,1875500,15645.0,,121974
R0000607,2024,1075200,1971600,3046800,72038.0,,200451
R0000610,2024,609900,1286700,1896600,40863.0,,123387
R0000612,2024,168190,1513710,1681900,11269.0,,109002
R0000613,2024,1025800,1178500,2204300,68728.0,,144003
R0000618,2024,294800,764700,1059500,19752.0,,67302
R0000621,2024,2868700,2132400,5001100,192203.0,,331389
R0000622,2024,1178000,1495100,2673100,78926.0,,175413
R0000626,2024,1183400,2390700,3574100,79288.0,,235780
R0000632,2024,1257000,1442800,2699800,84219.0,,177202
R0000634,2024,140680,1266120,1406800,9426.0,,90571
R0000640,2024,1004700,1672500,2677200,67315.0,,175687
R0000641,2024,2655500,1091700,3747200,177919.0,,247377
R0000646,2024,3590200,2490500,6080700,240543.0,,403722
R0000647,2024,2316200,1592100,3908300,155185.0,,258171
R0000651,2024,547600,773800,1321400,36689.0,,84849
R0000652,2024,653400,1036500,1689900,43778.0,,109538
R0000653,2024,557400,966200,1523600,37346.0,,98396
R0000656,2024,333000,1046700,1379700,22311.0,,88755
R0000658,2024,868400,658000,1526400,58183.0,,98584
R0000659,2024,470400,563000,1033400,31517.0,,65553
R0000660,2024,570100,927700,1497800,38197.0,,96668
R0000665,2024,24515,2206350,2230865,1643.0,,145783
R0000667,2024,1289700,1045600,2335300,82725.0,,152780
R0000670,2024,562600,772400,1335000,37694.0,,85760
R0000673,2024,918300,1071300,1989600,61526.0,,129618
R0000682,2024,794900,1035400,1830300,53258.0,,118945
R0000687,2024,1082900,1633100,2716000,72554.0,,178287
R0000693,2024,484700,1164400,1649100,32475.0,,106805
R0000697,2024,741200,983900,1725100,49660.0,,111897
R0000700,2024,604300,948500,1552800,40488.0,,100353
R0000701,2024,264700,768000,1032700,17735.0,,65506
R0000702,2024,1834900,1772800,3607700,122938.0,,238031
R0000703,2024,613900,898600,1512500,41131.0,,97653
R0000705,2024,1408200,1014900,2423100,94349.0,,158663
R0000707,2024,665600,639700,1305300,44595.0,,83770
R0000709,2024,332900,874800,1207700,22304.0,,77231
R0000711,2024,578200,1359500,1937700,38739.0,,126141
R0000719,2024,785100,810800,1595900,52602.0,,103240
R0000720,2024,1325400,1336200,2661600,88802.0,,174642
R0000723,2024,2305800,946600,3252400,154489.0,,214226
R0000727,2024,1370300,1291100,2661400,91810.0,,174629
R0000728,2024,1480900,839400,2320300,95535.0,,151775
R0000731,2024,2192600,1807400,4000000,146904.0,,264315
R0000732,2024,436400,1261300,1697700,29239.0,,110061
R0000736,2024,401900,836200,1238100,26927.0,,79268
R0000740,2024,381800,708200,1090000,25581.0,,69345
R0000741,2024,2979300,1431100,4410400,199613.0,,291812
R0000746,2024,361970,3257730,3619700,24252.0,,238835
R0000747,2024,464300,904900,1369200,31108.0,,88051
R0000749,2024,156510,1408590,1565100,10486.0,,101177
R0000750,2024,1014600,1993300,3007900,67978.0,,197844
R0000751,2024,535558,1592800,2128358,35882.0,,138915
R0000761,2024,1184000,1636800,2820800,79328.0,,185309
R0000762,2024,1126600,1044100,2170700,75482.0,,141752
R0000765,2024,255900,747300,1003200,17145.0,,63529
R0000768,2024,1261100,833800,2094900,84494.0,,136673
R0000769,2024,614100,804700,1418800,41145.0,,91375
R0000770,2024,607400,1039500,1646900,40696.0,,106657
R0000773,2024,1728600,1098200,2826800,115816.0,,185711
R0000775,2024,2593500,1231700,3825200,173765.0,,252603
R0000776,2024,309700,893300,1203000,20750.0,,76916
R0000777,2024,490100,897000,1387100,29152.0,,89251
R0000778,2024,366800,906700,1273500,24576.0,,81640
R0000782,2024,491500,754900,1246400,32931.0,,79824
R0000783,2024,812300,810600,1622900,54424.0,,105049
R0000812,2024,561900,1007700,1569600,37647.0,,101478
R0000815,2024,789200,840600,1629800,52876.0,,105512
R0000817,2024,2265000,1174200,3439200,151755.0,,226741
R0000821,2024,970600,1365800,2336400,65030.0,,152854
R0000824,2024,903700,826200,1729900,60548.0,,112218
R0000830,2024,619100,629400,1248500,41480.0,,79965
R0000833,2024,647300,952700,1600000,43369.0,,103515
R0000835,2024,295400,720300,1015700,19792.0,,64367
R0000838,2024,1410500,832700,2243200,90818.0,,146609
R0000845,2024,1044900,1051000,2095900,70008.0,,136740
R0000848,2024,734700,1099000,1833700,49225.0,,119173
R0000850,2024,2095700,1811400,3907100,140412.0,,258091
R0000851,2024,2046900,1275900,3322800,137142.0,,218943
R0000852,2024,1180200,1058300,2238500,79073.0,,146295
R0000853,2024,1329400,1371500,2700900,89070.0,,177275
R0000855,2024,1567200,1358300,2925500,105002.0,,192324
R0000856,2024,1326900,900500,2227400,88902.0,,145551
R0000857,2024,601104,1822600,2423704,40274.0,,158703
R0000861,2024,725700,966800,1692500,48622.0,,109713
R0000862,2024,352400,916000,1268400,23611.0,,81298
R0000863,2024,193300,920600,1113900,12951.0,,70946
R0000865,2024,713900,634200,1348100,47831.0,,86638
R0000867,2024,678500,998500,1677000,45460.0,,108674
R0000868,2024,1162500,816800,1979300,77888.0,,128928
R0000870,2024,94940,854460,949400,6361.0,,59925
R0000873,2024,578200,1011200,1589400,38739.0,,102805
R0000880,2024,302600,970000,1272600,20275.0,,81579
R0000882,2024,565200,503600,1068800,34184.0,,67925
R0000886,2024,103110,927990,1031100,6908.0,,65399
R0000887,2024,417000,669700,1086700,27939.0,,69124
R0000889,2024,1261400,931400,2192800,84514.0,,143233
R0000890,2024,646500,795900,1442400,43316.0,,92956
R0000891,2024,406300,945000,1351300,27222.0,,86852
R0000904,2024,511700,1535600,2047300,34284.0,,133484
R0000907,2024,264200,1341400,1605600,17701.0,,103890
R0000908,2024,713500,1636500,2350000,47805.0,,153765
R0000909,2024,1276168,1479200,2755368,85503.0,,180925
R0000911,2024,869100,1489800,2358900,58230.0,,154361
R0000912,2024,1825300,1507400,3332700,122295.0,,219606
R0000918,2024,549400,2655800,3205200,36810.0,,211063
R0000920,2024,1032200,974300,2006500,69158.0,,130751
R0000921,2024,732700,778100,1510800,49091.0,,97539
R0000949,2024,2806400,1815500,4621900,188029.0,,305982
R0000954,2024,683500,1876300,2559800,45795.0,,167822
R0000961,2024,485800,935500,1421300,32549.0,,91542
R0000966,2024,445500,972200,1417700,29849.0,,91301
R0000973,2024,2318100,1049100,3367200,155313.0,,221917
R0000976,2024,383200,946800,1330000,21989.0,,85425
R0000977,2024,1473200,915800,2389000,98704.0,,156378
R0000978,2024,3298700,1586100,4884800,221013.0,,323597
R0000979,2024,1646300,1212300,2858600,110302.0,,187841
R0000980,2024,2331100,1390300,3721400,156184.0,,245649
R0000981,2024,2719800,962000,3681800,182227.0,,242996
R0000984,2024,1099600,1401600,2501200,73673.0,,163895
R0000988,2024,1084600,874000,1958600,72668.0,,127541
R0000994,2024,930100,1180700,2110800,62317.0,,137739
R0000996,2024,1600900,1092200,2693100,107260.0,,176753
R0000997,2024,338600,649400,988000,19001.0,,62511
R0001004,2024,543600,576000,1119600,36421.0,,71328
R0001006,2024,586400,723800,1310200,39289.0,,84098
R0001007,2024,632800,1674700,2307500,42398.0,,150918
R0001009,2024,344900,927600,1272500,23108.0,,81573
R0001011,2024,684600,942800,1627400,45868.0,,105351
R0001012,2024,538200,473300,1011500,36059.0,,64086
R0001013,2024,1800400,1064100,2864500,120627.0,,188237
R0001014,2024,818000,1625400,2443400,54806.0,,160023
R0001015,2024,229400,2064600,2294000,15370.0,,150013
R0001016,2024,2717400,2787000,5504400,182066.0,,365110
R0001017,2024,4945600,1636400,6582000,331355.0,,437309
R0001018,2024,797100,666700,1463800,53406.0,,94390
R0001020,2024,2133500,1311700,3445200,142945.0,,227143
R0001023,2024,267900,696000,963900,17949.0,,60896
R0001025,2024,1658800,1756500,3415300,111140.0,,225140
R0001029,2024,640000,1683100,2323100,42880.0,,151963
R0001030,2024,121770,1095930,1217700,8159.0,,77901
R0001032,2024,1096000,1142000,2238000,73432.0,,146261
R0001033,2024,953800,985200,1939000,63905.0,,126228
R0001034,2024,719700,845200,1564900,48220.0,,101163
R0001038,2024,4716900,1846200,6563100,316032.0,,436043
R0001041,2024,333600,841000,1174600,22351.0,,75013
R0001042,2024,393200,1638800,2032000,26344.0,,132459
R0001047,2024,2888700,2528800,5417500,193543.0,,359288
R0001049,2024,731300,835400,1566700,48997.0,,101284
R0001050,2024,791600,836600,1628200,53037.0,,105404
R0001051,2024,804400,961300,1765700,53895.0,,114617
R0001053,2024,798900,1098200,1897100,53526.0,,123421
R0001055,2024,487300,898500,1385800,32649.0,,89164
R0001059,2024,1854200,2327800,4182000,124231.0,,276509
R0001062,2024,1122300,1148800,2271100,75194.0,,148479
R0001063,2024,243920,2195280,2439200,16343.0,,159741
R0001066,2024,816400,974000,1790400,54699.0,,116272
R0001067,2024,98660,887940,986600,6610.0,,62417
R0001069,2024,719900,971900,1691800,48233.0,,109666
R0001070,2024,490300,1243900,1734200,32850.0,,112506
R0001076,2024,192000,926200,1118200,12864.0,,71234
R0001081,2024,1794300,1020600,2814900,120218.0,,184913
R0001082,2024,1160300,983600,2143900,77740.0,,139956
R0001086,2024,804900,1695100,2500000,53928.0,,163815
R0001087,2024,785000,836600,1621600,52595.0,,104962
R0001094,2024,2101100,1808100,3909200,140774.0,,258231
R0001096,2024,234020,2106180,2340200,15679.0,,153108
R0001099,2024,915300,961300,1876600,61325.0,,122047
R0001102,2024,843600,1310100,2153700,56521.0,,140613
R0001108,2024,1778100,3101000,4879100,119133.0,,323215
R0001111,2024,2963700,2631200,5594900,198568.0,,371173
R0001114,2024,745900,1155800,1901700,49975.0,,123729
R0001119,2024,439200,1262300,1701500,29426.0,,110316
R0001122,2024,441400,803200,1244600,29574.0,,79703
R0001125,2024,455600,1021000,1476600,30525.0,,95247
R0001134,2024,449700,837200,1286900,30130.0,,82537
R0001136,2024,352100,975300,1327400,23591.0,,85251
R0001138,2024,812100,850100,1662200,54411.0,,107682
R0001140,2024,358800,875100,1233900,24040.0,,78986
R0001141,2024,622300,1336300,1958600,41694.0,,127541
R0001142,2024,412900,931500,1344400,27664.0,,86390
R0001155,2024,123000,1062500,1185500,8241.0,,75744
R0001156,2024,282200,812100,1094300,18907.0,,69633
R0001163,2024,1984900,857900,2842800,132988.0,,186783
R0001165,2024,1753300,1115100,2868400,117471.0,,188498
R0001166,2024,1546300,1776900,3323200,103602.0,,218969
R0001167,2024,172350,1551150,1723500,11547.0,,111790
R0001171,2024,317000,977200,1294200,21239.0,,83026
R0001176,2024,267230,2405070,2672300,17904.0,,175359
R0001184,2024,103450,931050,1034500,6931.0,,65627
R0001189,2024,1879400,1293400,3172800,125920.0,,208893
R0001190,2024,346900,1208100,1555000,19557.0,,100500
R0001191,2024,514500,1153300,1667800,34472.0,,108058
R0001199,2024,1444100,1410000,2854100,96755.0,,187540
R0001200,2024,743800,1709200,2453000,46150.0,,160666
R0001205,2024,2896800,1904300,4801100,194086.0,,317989
R0001206,2024,621600,677000,1298600,41647.0,,83321
R0001209,2024,2525800,1065000,3590800,169229.0,,236899
R0001210,2024,497900,839100,1337000,33359.0,,85894
R0001212,2024,1244500,1843400,3087900,83382.0,,203204
R0001214,2024,472100,716700,1188800,31631.0,,75965
R0001225,2024,475700,1573000,2048700,31872.0,,133578
R0001238,2024,106570,959130,1065700,7140.0,,67717
R0001240,2024,436000,956600,1392600,29212.0,,89619
R0001242,2024,2037500,1595300,3632800,136513.0,,239713
R0001244,2024,108400,975600,1084000,7263.0,,68943
R0001248,2024,122560,1103040,1225600,8212.0,,78430
R0001257,2024,814100,862100,1676200,54545.0,,108620
R0001259,2024,1373600,1058500,2432100,92031.0,,159266
R0001263,2024,862000,831300,1693300,57754.0,,109766
R0001264,2024,285500,785500,1071000,19129.0,,68072
R0001271,2024,1103650,1083800,2187450,73945.0,,142874
R0001272,2024,1182500,871500,2054000,79228.0,,133933
R0001274,2024,277600,922400,1200000,14914.0,,76715
R0001275,2024,1965900,873000,2838900,131715.0,,186521
R0001277,2024,982300,1641400,2623700,65814.0,,172103
R0001280,2024,208660,1877940,2086600,13980.0,,136117
R0001284,2024,176200,1585800,1762000,11806.0,,114369
R0001285,2024,820600,1991900,2812500,54980.0,,184753
R0001287,2024,1928400,1872000,3800400,129203.0,,250942
R0001290,2024,1163300,825100,1988400,77941.0,,129538
R0001293,2024,3330600,2093200,5423800,223150.0,,359710
R0001294,2024,556000,1057500,1613500,37252.0,,104420
R0001301,2024,1087000,905400,1992400,72829.0,,129806
R0001309,2024,719000,628600,1347600,48173.0,,86604
R0001311,2024,425200,824300,1249500,28488.0,,80032
R0001314,2024,448200,754600,1202800,30029.0,,76903
R0001319,2024,369000,1005100,1374100,24723.0,,88380
R0001320,2024,1509000,1074800,2583800,101103.0,,169430
R0001324,2024,327000,746600,1073600,21909.0,,68246
R0001325,2024,1131400,709500,1840900,75804.0,,119655
R0001326,2024,502100,1650100,2152200,33641.0,,140512
R0001342,2024,1584800,2150100,3734900,106182.0,,246553
R0001343,2024,717000,561000,1278000,48039.0,,81941
R0001344,2024,962300,1744900,2707200,64474.0,,177697
R0001348,2024,581100,1594600,2175700,38934.0,,142087
R0001356,2024,712200,1543600,2255800,47717.0,,147454
R0001357,2024,2568100,1299900,3868000,172063.0,,255471
R0001361,2024,162300,764700,927000,10874.0,,58424
R0001362,2024,2455000,1694000,4149000,164485.0,,274298
R0001363,2024,1970700,1931300,3902000,132037.0,,257749
R0001370,2024,798300,831800,1630100,53486.0,,105532
R0001373,2024,346800,989900,1336700,19551.0,,85874
R0001378,2024,873800,992200,1866000,58545.0,,121337
R0001390,2024,151320,1361880,1513200,10138.0,,97699
R0001393,2024,322400,801300,1123700,17916.0,,71603
R0001395,2024,448000,1027000,1475000,30016.0,,95140
R0001397,2024,1373100,1033700,2406800,91998.0,,157571
R0001402,2024,319000,821600,1140600,21373.0,,72735
R0001405,2024,538300,1245100,1783400,36066.0,,115803
R0001408,2024,576700,771200,1347900,38639.0,,86624
R0001412,2024,514000,1688800,2202800,34438.0,,143903
R0001419,2024,1330400,1187300,2517700,89137.0,,165001
R0001421,2024,335600,853400,1189000,22485.0,,75978
R0001430,2024,496100,769500,1265600,33239.0,,81110
R0001439,2024,472800,566600,1039400,31678.0,,65955
R0001441,2024,671400,783800,1455200,44984.0,,93813
R0001442,2024,204000,1294400,1498400,13668.0,,96708
R0001444,2024,206700,915700,1122400,13849.0,,71516
R0001445,2024,493700,746000,1239700,33078.0,,79375
R0001448,2024,2085501,1117700,3203201,139728.0,,210929
R0001453,2024,268800,951000,1219800,18010.0,,78042
R0001458,2024,667600,1786300,2453900,44729.0,,160726
R0001460,2024,436900,1049700,1486600,29272.0,,95917
R0001462,2024,456200,601900,1058100,30565.0,,67208
R0001464,2024,490800,1461900,1952700,32884.0,,127146
R0001470,2024,189000,1071000,1260000,12663.0,,80735
R0001472,2024,1765800,1522300,3288100,118309.0,,216618
R0001478,2024,858600,678000,1536600,57526.0,,99267
R0001479,2024,797800,1261300,2059100,53453.0,,134275
R0001481,2024,1523200,1194000,2717200,102054.0,,178367
R0001482,2024,565000,865000,1430000,37855.0,,92125
R0001483,2024,1438200,1310600,2748800,96359.0,,180485
R0001487,2024,427200,895600,1322800,28622.0,,84943
R0001488,2024,688000,1032000,1720000,42411.0,,111555
R0001506,2024,1673700,1043300,2717000,108453.0,,178354
R0001507,2024,362900,1122900,1485800,24314.0,,95864
R0001517,2024,3284219,2240500,5524719,220043.0,,366471
R0001519,2024,1046800,1082300,2129100,70136.0,,138965
R0001521,2024,101380,912420,1013800,6792.0,,64240
R0001524,2024,265020,2385180,2650200,17756.0,,173878
R0001526,2024,272000,1199300,1471300,18224.0,,94892
R0001529,2024,575100,753900,1329000,38532.0,,85358
R0001533,2024,512300,844600,1356900,34324.0,,87227
R0001534,2024,201100,842900,1044000,13474.0,,66263
R0001535,2024,477800,1349300,1827100,32012.0,,118731
R0001536,2024,294300,790000,1084300,19718.0,,68963
R0001542,2024,1141600,1033400,2175000,76487.0,,142040
R0001543,2024,515500,1101800,1617300,34539.0,,104674
R0001544,2024,1229600,823200,2052800,82383.0,,133853
R0001545,2024,1844100,1250700,3094800,123555.0,,203667
R0001546,2024,896900,1345400,2242300,56407.0,,146549
R0001547,2024,848400,1922800,2771200,56843.0,,181985
R0001548,2024,1479000,1632400,3111400,99093.0,,204779
R0001551,2024,252300,786400,1038700,16904.0,,65908
R0001556,2024,1028800,834800,1863600,68930.0,,121176
R0001558,2024,1575332,1640700,3216032,105547.0,,211789
R0001562,2024,405100,844900,1250000,27142.0,,80065
R0001564,2024,1123700,2484400,3608100,75288.0,,238058
R0001569,2024,390900,664900,1055800,26190.0,,67054
R0001573,2024,541300,404700,946000,36267.0,,59697
R0001584,2024,608200,835900,1444100,40749.0,,93070
R0001587,2024,925900,1269900,2195800,62035.0,,143434
R0001588,2024,1848000,1170500,3018500,123816.0,,198555
R0001610,2024,820100,2950100,3770200,54947.0,,248918
R0001614,2024,144900,961900,1106800,9708.0,,70471
R0001615,2024,561400,1054000,1615400,37614.0,,104547
R0001618,2024,5098200,2322700,7420900,341579.0,,493515
R0001623,2024,456000,882400,1338400,26867.0,,85988
R0001624,2024,420900,666700,1087600,24515.0,,69184
R0001626,2024,71100,1109800,1180900,1078.0,,75435
R0001629,2024,956700,1143400,2100100,64099.0,,137022
R0001630,2024,459500,656000,1115500,30787.0,,71054
R0001633,2024,607300,1051400,1658700,37004.0,,107448
R0001634,2024,140200,947800,1088000,9393.0,,69211
R0001635,2024,249800,2128500,2378300,16737.0,,155661
R0001637,2024,1021400,841200,1862600,68434.0,,121109
R0001641,2024,1477400,876800,2354200,98986.0,,154046
R0001652,2024,466400,1068600,1535000,31249.0,,99160
R0001655,2024,949700,943000,1892700,63630.0,,123126
R0001656,2024,2923800,1052000,3975800,195895.0,,262694
R0001658,2024,337400,767100,1104500,22606.0,,70317
R0001661,2024,555700,2301900,2857600,37232.0,,187774
R0001662,2024,1268800,1273200,2542000,85010.0,,166629
R0001664,2024,682400,1159500,1841900,45721.0,,119722
R0001730,2024,437700,764800,1202500,29326.0,,76883
R0001731,2024,3794800,1742400,5537200,254252.0,,367307
R0001737,2024,1916200,1644400,3560600,128385.0,,234875
R0001741,2024,123190,1108710,1231900,8254.0,,78852
R0001752,2024,389600,1035700,1425300,26103.0,,91810
R0001753,2024,791000,1065300,1856300,52997.0,,120687
R0001754,2024,1290100,1513000,2803100,86437.0,,184123
R0001759,2024,802700,1840000,2642700,53781.0,,173376
R0001760,2024,1521000,1077000,2598000,101907.0,,170381
R0001763,2024,957300,1175900,2133200,64139.0,,139239
R0001769,2024,305100,1068000,1373100,20442.0,,88313
R0001773,2024,3020800,1740900,4761700,202394.0,,315349
R0001781,2024,718700,1371300,2090000,44468.0,,136345
R0001784,2024,387100,997900,1385000,25936.0,,89110
R0001785,2024,1070300,1295300,2365600,71710.0,,154810
R0001786,2024,918400,1601800,2520200,61533.0,,165168
R0001788,2024,408100,1355500,1763600,27343.0,,114476
R0001789,2024,1591300,1113900,2705200,106617.0,,177563
R0001791,2024,1104600,1686500,2791100,74008.0,,183319
R0001793,2024,755200,569000,1324200,50598.0,,85036
R0001796,2024,273400,1371500,1644900,18318.0,,106523
R0001797,2024,619300,1675400,2294700,41493.0,,150060
R0001799,2024,183910,1655190,1839100,12322.0,,119535
R0001801,2024,362900,831800,1194700,24314.0,,76360
R0001809,2024,852300,1532900,2385200,57104.0,,156123
R0001810,2024,491600,1635100,2126700,32937.0,,138804
R0001819,2024,971800,1360900,2332700,65111.0,,152606
R0001823,2024,945900,954100,1900000,63375.0,,123615
R0001824,2024,658900,650600,1309500,44146.0,,84052
R0001826,2024,437700,762400,1200100,29326.0,,76722
R0001827,2024,230500,551900,782400,15444.0,,48736
R0001831,2024,746700,640400,1387100,46344.0,,89251
R0001832,2024,299400,1551000,1850400,20060.0,,120292
R0001838,2024,1504900,1000000,2504900,100828.0,,164143
R0001840,2024,300600,1781900,2082500,20140.0,,135843
R0001845,2024,478700,1346200,1824900,32073.0,,118583
R0001847,2024,797700,840800,1638500,53446.0,,106095
R0001854,2024,4263400,1824600,6088000,285648.0,,404211
R0001865,2024,2192900,1460400,3653300,146924.0,,241086
R0001867,2024,1232600,1933100,3165700,82584.0,,208417
R0001869,2024,624100,1280100,1904200,41815.0,,123896
R0001870,2024,190900,1051300,1242200,12790.0,,79542
R0001872,2024,559800,783100,1342900,37507.0,,86289
R0001876,2024,795900,899700,1695600,53325.0,,109920
R0001877,2024,107760,969840,1077600,7220.0,,68514
R0001878,2024,767500,810500,1578000,51423.0,,102041
R0001880,2024,544700,967600,1512300,36495.0,,97639
R0001881,2024,205350,1848150,2053500,13758.0,,133900
R0001888,2024,786900,974900,1761800,52722.0,,114356
R0001895,2024,1804600,1072500,2877100,120908.0,,189081
R0001896,2024,829200,752000,1581200,55556.0,,102255
R0001901,2024,2941600,2301000,5242600,197087.0,,347569
R0001907,2024,445600,842400,1288000,29855.0,,82611
R0001910,2024,965300,1800800,2766100,60990.0,,181644
R0001913,2024,680900,1092400,1773300,45620.0,,115126
R0001914,2024,194190,1747710,1941900,13011.0,,126422
R0001915,2024,1258900,1274400,2533300,84346.0,,166046
R0001921,2024,1858500,2090400,3948900,124520.0,,260891
R0001923,2024,1434800,1140200,2575000,92447.0,,168840
R0001924,2024,429400,977000,1406400,28770.0,,90544
R0001926,2024,2541200,1235800,3777000,170260.0,,249374
R0001929,2024,1732900,1183000,2915900,116104.0,,191680
R0001931,2024,119880,1078920,1198800,8032.0,,76635
R0001936,2024,1124200,675300,1799500,71637.0,,116882
R0001947,2024,710300,1149700,1860000,47590.0,,120935
R0001954,2024,205130,1846170,2051300,13744.0,,133752
R0001958,2024,87740,789660,877400,5879.0,,55101
R0001960,2024,95690,861210,956900,6411.0,,60427
R0001962,2024,220700,867500,1088200,14787.0,,69224
R0001963,2024,389100,576300,965400,26070.0,,60997
R0001964,2024,425300,579500,1004800,28495.0,,63637
R0001965,2024,1300400,1306200,2606600,87127.0,,170957
R0001972,2024,1136700,1266700,2403400,76159.0,,157343
R0001977,2024,2066977,1786900,3853877,138487.0,,254525
R0001978,2024,333600,1109400,1443000,22351.0,,92996
R0001980,2024,332400,563400,895800,22271.0,,56334
R0001981,2024,499100,831600,1330700,33440.0,,85472
R0001984,2024,2672800,1886900,4559700,179078.0,,301815
R0001985,2024,1827800,860400,2688200,122463.0,,176424
R0001986,2024,2710700,1424600,4135300,181617.0,,273380
R0001987,2024,720800,749100,1469900,48294.0,,94798
R0001988,2024,1016900,1011200,2028100,68132.0,,132198
R0001993,2024,399900,1357600,1757500,26793.0,,114068
R0001994,2024,330200,878300,1208500,22123.0,,77285
R0001998,2024,218400,1795700,2014100,14633.0,,131260
R0001999,2024,1562100,1079600,2641700,104661.0,,173309
R0002001,2024,505000,990500,1495500,33835.0,,96514
R0002007,2024,619800,1117500,1737300,41527.0,,112714
R0002010,2024,191180,1720620,1911800,12809.0,,124406
R0002011,2024,595600,592600,1188200,39905.0,,75924
R0002013,2024,252600,790300,1042900,16924.0,,66189
R0002017,2024,279700,825600,1105300,18740.0,,70370
R0002018,2024,552300,990600,1542900,37004.0,,99689
R0002019,2024,917300,745900,1663200,61459.0,,107749
R0002022,2024,844600,954600,1799200,56588.0,,116861
R0002024,2024,373600,671400,1045000,25031.0,,66330
R0002028,2024,1159000,874800,2033800,77653.0,,132580
R0002033,2024,770100,962700,1732800,51597.0,,112413
R0002034,2024,602800,809300,1412100,40388.0,,90926
R0002035,2024,1540400,1088400,2628800,103207.0,,172445
R0002044,2024,572590,5153310,5725900,38364.0,,379950
R0002047,2024,1596100,936300,2532400,106939.0,,165986
R0002048,2024,847900,1732300,2580200,56809.0,,169188
R0002050,2024,377000,829500,1206500,25259.0,,77151
R0002051,2024,3579000,1986700,5565700,239793.0,,369217
R0002053,2024,588200,717400,1305600,39409.0,,83790
R0002054,2024,428200,1215500,1643700,28689.0,,106443
R0002057,2024,1016500,1583200,2599700,68106.0,,170495
R0002059,2024,2439600,1803200,4242800,163453.0,,280583
R0002060,2024,1258900,1063600,2322500,84346.0,,151923
R0002064,2024,181020,1629180,1810200,12128.0,,117598
R0002065,2024,1603600,1124200,2727800,107441.0,,179078
R0002068,2024,475100,1174900,1650000,28147.0,,106865
R0002069,2024,850000,850000,1700000,56950.0,,110215
R0002076,2024,1233000,1080800,2313800,82611.0,,151340
R0002077,2024,355400,898800,1254200,23812.0,,80346
R0002079,2024,905345,3371500,4276845,60658.0,,282864
R0002087,2024,793300,1783200,2576500,53151.0,,168941
R0002091,2024,99890,685110,785000,3008.0,,48910
R0002092,2024,1320300,1063400,2383700,88460.0,,156023
R0002093,2024,266900,1611600,1878500,17882.0,,122175
R0002099,2024,650100,1068600,1718700,43556.0,,111468
R0002103,2024,725500,827800,1553300,48609.0,,100386
R0002105,2024,446600,843700,1290300,29922.0,,82765
R0002111,2024,1318100,1090300,2408400,88313.0,,157678
R0002114,2024,325600,955000,1280600,18130.0,,82115
R0002116,2024,1119800,816600,1936400,75027.0,,126054
R0002121,2024,434400,420800,855200,29105.0,,53613
R0002126,2024,1344500,1374600,2719100,90082.0,,178495
R0002129,2024,472100,1102500,1574600,31631.0,,101813
R0002134,2024,1814900,1994800,3809700,121598.0,,251565
R0002140,2024,1876300,824200,2700500,125712.0,,177249
R0002143,2024,956900,863800,1820700,64112.0,,118302
R0002145,2024,1113546,868700,1982246,74608.0,,129125
R0002146,2024,152100,766900,919000,10191.0,,57888
R0002150,2024,529300,850500,1379800,35463.0,,88762
R0002159,2024,213600,281500,495100,14311.0,,29487
R0002162,2024,1090400,1301400,2391800,73057.0,,156566
R0002169,2024,432900,1465300,1898200,29004.0,,123494
R0002171,2024,1025300,969500,1994800,68695.0,,129967
R0002176,2024,415200,1014100,1429300,27818.0,,92078
R0002180,2024,894300,755500,1649800,59918.0,,106852
R0002181,2024,183600,1139000,1322600,12301.0,,84929
R0002182,2024,508200,1817600,2325800,34049.0,,152144
R0002186,2024,438400,916800,1355200,29373.0,,87113
R0002191,2024,587100,802600,1389700,39336.0,,89425
R0002195,2024,1149800,1887400,3037200,77037.0,,199807
R0002199,2024,1242000,866200,2108200,83214.0,,137564
R0002202,2024,1654300,1177700,2832000,110838.0,,186059
R0002206,2024,209170,1882530,2091700,14014.0,,136459
R0002213,2024,467300,989800,1457100,31309.0,,93941
R0002214,2024,1261700,1892000,3153700,84534.0,,207613
R0002215,2024,280500,901800,1182300,18794.0,,75529
R0002217,2024,899100,1280100,2179200,60240.0,,142321
R0002219,2024,584300,696000,1280300,39148.0,,82095
R0002223,2024,4429000,4215100,8644100,296743.0,,575470
R0002224,2024,1570900,1581100,3152000,105250.0,,207499
R0002225,2024,1326700,821200,2147900,88889.0,,140224
R0002226,2024,410300,1068400,1478700,27490.0,,95388
R0002228,2024,3432800,1328700,4761500,229998.0,,315336
R0002230,2024,167480,1507320,1674800,11221.0,,108527
R0002238,2024,1059300,1003100,2062400,70973.0,,134496
R0002239,2024,916000,977200,1893200,61372.0,,123159
R0002240,2024,792100,912900,1705000,53071.0,,110550
R0002243,2024,717100,704800,1421900,48046.0,,91582
R0002249,2024,879000,846700,1725700,58893.0,,111937
R0002250,2024,761400,892600,1654000,51014.0,,107133
R0002251,2024,2231500,2154100,4385600,149511.0,,290150
R0002253,2024,997800,1069600,2067400,66853.0,,134831
R0002255,2024,693000,1027000,1720000,46431.0,,111555
R0002262,2024,598600,2095500,2694100,40106.0,,176820
R0002264,2024,2206500,1697800,3904300,147836.0,,257903
R0002265,2024,815800,1175800,1991600,54659.0,,129752
R0002266,2024,4081900,2601300,6683200,273487.0,,444089
R0002271,2024,490000,762000,1252000,32830.0,,80199
R0002273,2024,874800,1179800,2054600,58612.0,,133973
R0002279,2024,593300,912400,1505700,39751.0,,97197
R0002283,2024,1157000,828000,1985000,77519.0,,129310
R0002284,2024,95000,705000,800000,6365.0,,49915
R0002291,2024,1588000,1832800,3420800,106396.0,,225509
R0002294,2024,114630,1031670,1146300,7680.0,,73117
R0002301,2024,1150500,1054300,2204800,77084.0,,144037
R0002303,2024,419200,1045500,1464700,28086.0,,94450
R0002305,2024,189250,1703250,1892500,12680.0,,123113
R0002306,2024,577700,1083400,1661100,38706.0,,107609
R0002309,2024,114890,1034010,1148900,7698.0,,73291
R0002316,2024,1888100,1493900,3382000,126503.0,,222909
R0002321,2024,1550000,1896200,3446200,103850.0,,227210
R0002324,2024,191100,1698700,1889800,12804.0,,122932
R0002343,2024,892400,829200,1721600,59791.0,,111662
R0002345,2024,1039700,960100,1999800,69660.0,,130302
R0002349,2024,215300,757400,972700,14425.0,,61486
R0002355,2024,1241900,954700,2196600,83207.0,,143487
R0002361,2024,650900,1075800,1726700,43610.0,,112004
R0002367,2024,1079100,1785000,2864100,72300.0,,188210
R0002368,2024,692300,1160400,1852700,46384.0,,120446
R0002373,2024,453200,660700,1113900,30365.0,,70946
R0002378,2024,744700,1364600,2109300,49895.0,,137638
R0002381,2024,342300,724000,1066300,22934.0,,67757
R0002384,2024,572000,832500,1404500,38324.0,,90417
R0002385,2024,381400,1060100,1441500,25554.0,,92896
R0002390,2024,681800,1110700,1792500,45681.0,,116413
R0002393,2024,1191200,925800,2117000,79810.0,,138154
R0002394,2024,561000,1425400,1986400,37587.0,,129404
R0002395,2024,1256300,2288900,3545200,84172.0,,233843
R0002400,2024,618900,1637500,2256400,41466.0,,147494
R0002402,2024,565200,1361100,1926300,37868.0,,125377
R0002404,2024,530600,1376900,1907500,35550.0,,124118
R0002415,2024,2560200,1642100,4202300,171533.0,,277869
R0002416,2024,624100,957600,1581700,41815.0,,102289
R0002425,2024,588700,1897300,2486000,39443.0,,162877
R0002434,2024,260200,1052700,1312900,17433.0,,84279
R0002437,2024,538000,897300,1435300,36046.0,,92480
R0002440,2024,1157900,1098700,2256600,77579.0,,147507
R0002446,2024,171900,1547100,1719000,11517.0,,111488
R0002447,2024,678700,946100,1624800,45473.0,,105177
R0002449,2024,242720,2184480,2427200,16262.0,,158937
R0002450,2024,1231100,1012000,2243100,82484.0,,146603
R0002451,2024,478000,1825100,2303100,32026.0,,150623
R0002455,2024,497400,651700,1149100,33326.0,,73305
R0002458,2024,774400,835700,1610100,51885.0,,104192
R0002467,2024,127590,1148310,1275900,8549.0,,81800
R0002475,2024,846100,1883900,2730000,56689.0,,179225
R0002480,2024,399400,670500,1069900,26760.0,,67998
R0002481,2024,5521000,1796000,7317000,369907.0,,486554
R0002484,2024,704700,842000,1546700,47215.0,,99944
R0002493,2024,479500,702700,1182200,32127.0,,75522
R0002497,2024,762600,1126400,1889000,51094.0,,122878
R0002502,2024,471700,757800,1229500,31604.0,,78692
R0002505,2024,563200,1062900,1626100,37734.0,,105264
R0002508,2024,123010,1107090,1230100,8242.0,,78732
R0002514,2024,177380,1596420,1773800,11884.0,,115160
R0002523,2024,1097900,2386800,3484700,73559.0,,229790
R0002525,2024,356300,1109200,1465500,23872.0,,94504
R0002527,2024,2725400,1765900,4491300,182602.0,,297232
R0002532,2024,1866200,1036600,2902800,125035.0,,190803
R0002538,2024,1489800,1807600,3297400,99817.0,,217241
R0002544,2024,215720,1941480,2157200,14453.0,,140847
R0002546,2024,978800,836900,1815700,65580.0,,117967
R0002557,2024,222000,1275500,1497500,14874.0,,96648
R0002560,2024,474500,1065300,1539800,31792.0,,99482
R0002564,2024,972100,954100,1926200,65131.0,,125370
R0002565,2024,1148600,893100,2041700,76956.0,,133109
R0002567,2024,1272800,1189900,2462700,85278.0,,161316
R0002573,2024,263800,1052200,1316000,17675.0,,84487
R0002574,2024,1043400,839800,1883200,66222.0,,122489
R0002577,2024,508200,1026200,1534400,34049.0,,99120
R0002581,2024,238960,2150640,2389600,16010.0,,156418
R0002582,2024,1500800,1502900,3003700,100554.0,,197563
R0002583,2024,95880,862920,958800,6424.0,,60555
R0002591,2024,645400,1261800,1907200,43241.0,,124097
R0002599,2024,869300,1187000,2056300,58243.0,,134087
R0002601,2024,477900,1222500,1700400,32019.0,,110242
R0002607,2024,500200,1790300,2290500,33513.0,,149779
R0002608,2024,128400,1055800,1184200,8603.0,,75656
R0002610,2024,346000,1348200,1694200,23182.0,,109826
R0002611,2024,717800,1270300,1988100,48093.0,,129518
R0002614,2024,162800,895200,1058000,10908.0,,67201
R0002616,2024,1119600,1745300,2864900,75013.0,,188263
R0002622,2024,1074200,1855000,2929200,71971.0,,192571
R0002624,2024,759500,851200,1610700,50887.0,,104232
R0002626,2024,591800,1316000,1907800,39651.0,,124138
R0002627,2024,1108200,837700,1945900,74249.0,,126690
R0002628,2024,711400,832800,1544200,47664.0,,99776
R0002629,2024,1694500,1004900,2699400,113532.0,,177175
R0002631,2024,987200,819000,1806200,66142.0,,117330
R0002637,2024,669100,1207200,1876300,44830.0,,122027
R0002654,2024,1898300,1061800,2960100,127186.0,,194642
R0002655,2024,3187523,1453600,4641123,213564.0,,307270
R0002669,2024,201400,906200,1107600,13494.0,,70524
R0002671,2024,307800,691800,999600,20623.0,,63288
R0002673,2024,960700,868900,1829600,64367.0,,118898
R0002674,2024,2317600,1006500,3324100,155279.0,,219030
R0002676,2024,412400,791100,1203500,27631.0,,76950
R0002678,2024,1555400,1224900,2780300,104212.0,,182595
R0002679,2024,1105000,838400,1943400,74035.0,,126523
R0002680,2024,110240,992160,1102400,7386.0,,70176
R0002681,2024,1113700,1104200,2217900,74618.0,,144914
R0002682,2024,1047900,1596800,2644700,70209.0,,173510
R0002688,2024,1241000,1541500,2782500,83147.0,,182743
R0002689,2024,1304400,838300,2142700,87395.0,,139876
R0002692,2024,1481100,963100,2444200,99234.0,,160076
R0002696,2024,368800,1354000,1722800,24710.0,,111743
R0002698,2024,664000,3244800,3908800,44488.0,,258205
R0002701,2024,2483500,1781000,4264500,166395.0,,282037
R0002702,2024,434000,908100,1342100,29078.0,,86236
R0002706,2024,1040800,969700,2010500,69734.0,,131019
R0002709,2024,1245500,1782800,3028300,83449.0,,199211
R0002716,2024,1922900,1695700,3618600,128834.0,,238761
R0002718,2024,696600,1035600,1732200,46672.0,,112372
R0002719,2024,961900,1115900,2077800,64447.0,,135528
R0002720,2024,1231400,755500,1986900,82504.0,,129437
R0002722,2024,580300,617200,1197500,38880.0,,76548
R0002724,2024,141080,1269720,1410800,9452.0,,90839
R0002725,2024,348600,1279600,1628200,23356.0,,105404
R0002726,2024,651800,1297600,1949400,39986.0,,126925
R0002738,2024,1046900,969600,2016500,70142.0,,131421
R0002748,2024,118540,1066860,1185400,7942.0,,75737
R0002749,2024,188760,1698840,1887600,12647.0,,122784
R0002751,2024,608200,952700,1560900,40749.0,,100895
R0002752,2024,807800,835900,1643700,54123.0,,106443
R0002754,2024,154400,970600,1125000,10345.0,,71690
R0002757,2024,266200,1128400,1394600,17835.0,,89753
R0002759,2024,130310,1172790,1303100,8731.0,,83623
R0002763,2024,215820,1942380,2158200,14460.0,,140914
R0002766,2024,531600,804300,1335900,35617.0,,85820
R0002767,2024,484700,1435100,1919800,28790.0,,124942
R0002771,2024,1083500,1027600,2111100,72595.0,,137759
R0002780,2024,845100,913700,1758800,56622.0,,114155
R0002787,2024,690600,805300,1495900,46270.0,,96540
R0002790,2024,923800,945000,1868800,61895.0,,121525
R0002794,2024,539000,756700,1295700,36113.0,,83127
R0002796,2024,1153500,896400,2049900,77285.0,,133658
R0002800,2024,2828300,1506400,4334700,189496.0,,286740
R0002804,2024,589900,937700,1527600,39523.0,,98664
R0002805,2024,403800,911300,1315100,27055.0,,84427
R0002808,2024,597100,568800,1165900,40006.0,,74430
R0002809,2024,1148200,896800,2045000,76929.0,,133330
R0002814,2024,1178300,1519100,2697400,78946.0,,177041
R0002816,2024,933600,1487900,2421500,62551.0,,158556
R0002817,2024,918700,831100,1749800,61553.0,,113552
R0002819,2024,293900,1027600,1321500,19691.0,,84856
R0002820,2024,665600,1257000,1922600,44595.0,,125129
R0002821,2024,612000,822700,1434700,41004.0,,92440
R0002823,2024,742200,848300,1590500,49727.0,,102879
R0002829,2024,1002200,1578500,2580700,67147.0,,169222
R0002830,2024,828600,818600,1647200,55516.0,,106677
R0002833,2024,171630,1544670,1716300,11499.0,,111307
R0002834,2024,118350,1065150,1183500,7929.0,,75610
R0002835,2024,111700,980900,1092600,7484.0,,69519
R0002838,2024,1669800,1640400,3310200,111877.0,,218098
R0002846,2024,422000,792200,1214200,28274.0,,77666
R0002850,2024,325700,852900,1178600,21822.0,,75281
R0002856,2024,437300,646800,1084100,29299.0,,68950
R0002857,2024,729800,949300,1679100,48897.0,,108815
R0002859,2024,276300,816800,1093100,18512.0,,69553
R0002860,2024,1645000,1912100,3557100,110215.0,,234641
R0002861,2024,1637200,1229500,2866700,109692.0,,188384
R0002864,2024,434100,1034700,1468800,29085.0,,94725
R0002874,2024,294800,776300,1071100,19752.0,,68079
R0002878,2024,1380900,829600,2210500,92520.0,,144419
R0002886,2024,325000,974500,1299500,18090.0,,83382
R0002894,2024,1034800,905200,1940000,69332.0,,126295
R0002896,2024,772700,596700,1369400,51771.0,,88065
R0002897,2024,2587375,1041200,3628575,169670.0,,239430
R0002899,2024,986700,1066000,2052700,66109.0,,133846
R0002902,2024,1985700,1371300,3357000,133042.0,,221234
R0002905,2024,201600,1688400,1890000,13507.0,,122945
R0002906,2024,1841100,832700,2673800,123354.0,,175460
R0002916,2024,1133600,830300,1963900,75951.0,,127896
R0002917,2024,480900,1054700,1535600,32220.0,,99200
R0002921,2024,439100,1511300,1950400,29420.0,,126992
R0002923,2024,573300,1065700,1639000,38411.0,,106128
R0002928,2024,390200,562900,953100,26143.0,,60173
R0002931,2024,829200,1219500,2048700,55556.0,,133578
R0002935,2024,364000,844300,1208300,20703.0,,77271
R0002939,2024,919300,1622700,2542000,61593.0,,166629
R0002940,2024,1941100,1638100,3579200,130054.0,,236121
R0002941,2024,1322900,1655900,2978800,88634.0,,195895
R0002945,2024,110300,992700,1103000,7390.0,,70216
R0002950,2024,689500,1907100,2596600,46197.0,,170287
R0002951,2024,894300,1006400,1900700,59918.0,,123662
R0002952,2024,0,246800,246800,0.0,,12851
R0002954,2024,208080,1872720,2080800,13941.0,,135729
R0002956,2024,665900,1146900,1812800,44615.0,,117773
R0002961,2024,978000,751100,1729100,65526.0,,112165
R0002962,2024,619700,1364100,1983800,41520.0,,129230
R0002963,2024,305700,1012900,1318600,20482.0,,84661
R0002964,2024,76390,687510,763900,5118.0,,47496
R0002965,2024,737600,720100,1457700,49419.0,,93981
R0002968,2024,330200,838200,1168400,22123.0,,74598
R0002971,2024,882100,1116500,1998600,59101.0,,130221
R0002973,2024,148340,1335060,1483400,9939.0,,95703
R0002975,2024,127580,1148220,1275800,8548.0,,81794
R0002982,2024,800100,762400,1562500,53607.0,,101003
R0002991,2024,333100,862700,1195800,22318.0,,76434
R0003001,2024,209300,1196700,1406000,14023.0,,90517
R0003008,2024,1962300,1030600,2992900,131474.0,,196839
R0003010,2024,663000,694500,1357500,44421.0,,87268
R0003015,2024,191560,1724040,1915600,12835.0,,124660
R0003018,2024,1994600,1718300,3712900,133638.0,,245079
R0003031,2024,45962,301125,347087,3079.0,,21411
R0003032,2024,78575,566650,645225,5265.0,,41388
R0003034,2024,544100,641000,1185100,36455.0,,75717
R0003035,2024,938600,1208800,2147400,62886.0,,140191
R0003040,2024,241500,714500,956000,16181.0,,60367
R0003041,2024,388900,677700,1066600,26056.0,,67777
R0003042,2024,196100,413900,610000,9454.0,,37185
R0003051,2024,1950700,1561300,3512000,130697.0,,231619
R0003052,2024,812300,822700,1635000,54424.0,,105860
R0003056,2024,918100,1358000,2276100,61513.0,,148814
R0003059,2024,831300,1368400,2199700,55697.0,,143695
R0003066,2024,272900,541800,814700,18284.0,,50900
R0003070,2024,412800,770700,1183500,27658.0,,75610
R0003078,2024,394700,1024100,1418800,26445.0,,91375
R0003081,2024,265000,1564300,1829300,17755.0,,118878
R0003083,2024,712100,653600,1365700,47711.0,,87817
R0003084,2024,1756900,1850700,3607600,117712.0,,238024
R0003085,2024,378600,795700,1174300,25366.0,,74993
R0003086,2024,695700,1066500,1762200,46612.0,,114382
R0003092,2024,937400,1034100,1971500,62806.0,,128406
R0003094,2024,123480,1111320,1234800,8273.0,,79047
R0003095,2024,151000,1200600,1351600,10117.0,,86872
R0003096,2024,108187,1080800,1188987,7249.0,,75977
R0003097,2024,487500,838000,1325500,32663.0,,85124
R0003100,2024,742500,911200,1653700,49748.0,,107113
R0003104,2024,961500,1055700,2017200,64421.0,,131467
R0003106,2024,249600,823900,1073500,16723.0,,68240
R0003107,2024,1336600,994100,2330700,89552.0,,152472
R0003109,2024,830000,648800,1478800,55610.0,,95395
R0003112,2024,1058000,1378000,2436000,70886.0,,159527
R0003115,2024,1237400,976300,2213700,82906.0,,144633
R0003116,2024,551100,981700,1532800,36924.0,,99013
R0003118,2024,474400,1000000,1474400,31785.0,,95100
R0003122,2024,171280,1541520,1712800,11476.0,,111073
R0003126,2024,692900,641600,1334500,46424.0,,85727
R0003127,2024,662400,1382200,2044600,44381.0,,133303
R0003144,2024,420000,870700,1290700,28140.0,,82792
R0003155,2024,818500,828100,1646600,54840.0,,106637
R0003165,2024,791800,819400,1611200,53051.0,,104265
R0003170,2024,1284300,1523600,2807900,86048.0,,184444
R0003171,2024,523300,745800,1269100,35061.0,,81345
R0003173,2024,1029500,856400,1885900,68977.0,,122670
R0003175,2024,357600,1500800,1858400,20274.0,,120828
R0003177,2024,212050,1908450,2120500,14207.0,,138389
R0003184,2024,655500,1348500,2004000,43919.0,,130583
R0003189,2024,1723900,1273700,2997600,115501.0,,197154
R0003191,2024,2055700,1214300,3270000,137732.0,,215405
R0003193,2024,776000,871400,1647400,51992.0,,106691
R0003195,2024,244800,741500,986300,16402.0,,62397
R0003203,2024,546000,842000,1388000,36582.0,,89311
R0003204,2024,602800,819800,1422600,40388.0,,91629
R0003206,2024,65100,659900,725000,4362.0,,44890
R0003209,2024,428000,841000,1269000,28676.0,,81338
R0003212,2024,758600,901200,1659800,50826.0,,107522
R0003216,2024,266300,1865000,2131300,17842.0,,139112
R0003217,2024,713700,641800,1355500,47818.0,,87134
R0003228,2024,495800,836700,1332500,33219.0,,85593
R0003229,2024,801600,1183500,1985100,53707.0,,129317
R0003231,2024,358300,843200,1201500,24006.0,,76816
R0003233,2024,458800,868400,1327200,30740.0,,85237
R0003236,2024,1858600,1076900,2935500,124526.0,,192994
R0003237,2024,230300,924300,1154600,15430.0,,73673
R0003239,2024,701300,909000,1610300,46987.0,,104205
R0003240,2024,202400,1362600,1565000,13561.0,,101170
R0003242,2024,521501,922700,1444201,34941.0,,93076
R0003245,2024,971400,1563000,2534400,65084.0,,166120
R0003246,2024,586500,843500,1430000,35610.0,,92125
R0003247,2024,1664400,1042800,2707200,111515.0,,177697
R0003251,2024,182600,1041500,1224100,12234.0,,78330
R0003253,2024,352100,1372700,1724800,23591.0,,111877
R0003255,2024,929600,1342900,2272500,62283.0,,148573
R0003258,2024,1313900,1348000,2661900,88031.0,,174662
R0003262,2024,417600,1211600,1629200,27979.0,,105471
R0003264,2024,157450,1417050,1574500,10549.0,,101807
R0003266,2024,1604000,1525200,3129200,107468.0,,205971
R0003270,2024,150420,1353780,1504200,10078.0,,97096
R0003272,2024,169500,1145500,1315000,11357.0,,84420
R0003278,2024,2897700,2530200,5427900,194146.0,,359984
R0003282,2024,658900,1364000,2022900,44146.0,,131849
R0003292,2024,752600,872400,1625000,50424.0,,105190
R0003293,2024,1887500,1840100,3727600,126463.0,,246064
R0003295,2024,713200,822900,1536100,47784.0,,99234
R0003298,2024,922400,925000,1847400,61801.0,,120091
R0003303,2024,86400,873600,960000,5789.0,,60635
R0003305,2024,328300,940900,1269200,21996.0,,81351
R0003307,2024,272300,1419600,1691900,18244.0,,109672
R0003310,2024,3112500,1636700,4749200,208538.0,,314511
R0003312,2024,739800,1663200,2403000,49567.0,,157316
R0003314,2024,920800,1034100,1954900,61694.0,,127293
R0003317,2024,1228000,2041400,3269400,82276.0,,215365
R0003318,2024,785100,1451300,2236400,52602.0,,146154
R0003320,2024,567700,729700,1297400,38036.0,,83241
R0003327,2024,144730,1302570,1447300,9697.0,,93284
R0003332,2024,741500,1014100,1755600,49681.0,,113940
R0003336,2024,550000,800000,1350000,36850.0,,86765
R0003338,2024,1635300,1549700,3185000,109565.0,,209710
R0003339,2024,332701,1042500,1375201,22291.0,,88453
R0003341,2024,189600,1047900,1237500,12703.0,,79228
R0003342,2024,952700,819200,1771900,63831.0,,115032
R0003343,2024,227700,2049300,2277000,15256.0,,148874
R0003345,2024,2470200,2426000,4896200,165503.0,,324360
R0003350,2024,690800,690100,1380900,46284.0,,88835
R0003351,2024,326600,490000,816600,18197.0,,51027
R0003352,2024,192400,1374200,1566600,12891.0,,101277
R0003357,2024,1931100,1065100,2996200,129384.0,,197060
R0003360,2024,809000,943500,1752500,54203.0,,113733
R0003366,2024,551300,1128100,1679400,36937.0,,108835
R0003369,2024,196530,1768770,1965300,13168.0,,127990
R0003377,2024,1121300,1015500,2136800,75127.0,,139481
R0003379,2024,2061500,1035000,3096500,138121.0,,203781
R0003387,2024,615100,1911300,2526400,41212.0,,165584
R0003393,2024,711500,841600,1553100,47671.0,,100373
R0003395,2024,876100,707900,1584000,58699.0,,102443
R0003396,2024,661100,648100,1309200,44294.0,,84031
R0003401,2024,662300,1399200,2061500,44374.0,,134436
R0003403,2024,335200,829900,1165100,22458.0,,74377
R0003406,2024,2119100,3158500,5277600,141979.0,,349914
R0003411,2024,2225800,2233300,4459100,149129.0,,295075
R0003413,2024,1133100,1652800,2785900,75918.0,,182970
R0003416,2024,971900,1162600,2134500,65117.0,,139327
R0003420,2024,705000,1085800,1790800,47235.0,,116299
R0003424,2024,983800,1735100,2718900,65915.0,,178481
R0003430,2024,1505000,845400,2350400,100835.0,,153792
R0003431,2024,1571500,845800,2417300,105291.0,,158274
R0003436,2024,382000,1131600,1513600,25594.0,,97726
R0003438,2024,1088000,821800,1909800,72896.0,,124272
R0003439,2024,549100,938200,1487300,36790.0,,95964
R0003441,2024,440800,1263000,1703800,29534.0,,110470
R0003444,2024,1065000,1209700,2274700,71355.0,,148720
R0003446,2024,507300,1230400,1737700,33989.0,,112741
R0003448,2024,120380,1083420,1203800,8065.0,,76970
R0003456,2024,802700,953500,1756200,53781.0,,113980
R0003459,2024,1450000,1450000,2900000,97150.0,,190615
R0003461,2024,533700,834100,1367800,35758.0,,87958
R0003463,2024,1205000,1109500,2314500,80735.0,,151387
R0003464,2024,1602300,1141600,2743900,107354.0,,180156
R0003466,2024,2075200,1564500,3639700,139038.0,,240175
R0003468,2024,954600,821000,1775600,63958.0,,115280
R0003474,2024,881200,847700,1728900,59040.0,,112151
R0003475,2024,1026600,826300,1852900,68782.0,,120459
R0003477,2024,205500,749700,955200,10083.0,,60313
R0003480,2024,1268500,709100,1977600,84990.0,,128814
R0003481,2024,2215200,1003000,3218200,148418.0,,211934
R0003483,2024,103500,900200,1003700,6935.0,,63563
R0003488,2024,1752200,1098400,2850600,117397.0,,187305
R0003492,2024,158910,1430190,1589100,10647.0,,102785
R0003494,2024,715700,1332100,2047800,47952.0,,133518
R0003501,2024,494000,924300,1418300,33098.0,,91341
R0003504,2024,583500,708700,1292200,39095.0,,82892
R0003506,2024,1684800,1094400,2779200,112882.0,,182521
R0003508,2024,246200,985500,1231700,16495.0,,78839
R0003509,2024,557400,1015400,1572800,37346.0,,101693
R0003510,2024,1793600,1801800,3595400,120171.0,,237207
R0003511,2024,475600,1124400,1600000,31865.0,,103515
R0003512,2024,395900,873500,1269400,26525.0,,81365
R0003513,2024,1167600,888700,2056300,78229.0,,134087
R0003516,2024,860700,1185500,2046200,57667.0,,133410
R0003518,2024,1047900,833800,1881700,70209.0,,122389
R0003519,2024,232000,803300,1035300,15544.0,,65680
R0003524,2024,2595800,1077900,3673700,173919.0,,242453
R0003526,2024,193700,1356300,1550000,12978.0,,100165
R0003527,2024,572700,660000,1232700,38371.0,,78906
R0003528,2024,148390,1335510,1483900,9942.0,,95736
R0003529,2024,1237700,1082700,2320400,82925.0,,151782
R0003536,2024,667700,1349900,2017600,44736.0,,131494
R0003539,2024,474000,1057200,1531200,31758.0,,98905
R0003540,2024,400400,1315300,1715700,26827.0,,111267
R0003541,2024,3011300,2790800,5802100,201757.0,,385056
R0003543,2024,1052200,1820300,2872500,70497.0,,188773
R0003544,2024,1086700,2056200,3142900,72809.0,,206889
R0003548,2024,963200,1046900,2010100,64534.0,,130992
R0003550,2024,2289400,1780700,4070100,153390.0,,269012
R0003556,2024,1751800,1432600,3184400,117371.0,,209670
R0003562,2024,553400,885800,1439200,37078.0,,92741
R0003563,2024,699800,822000,1521800,46887.0,,98276
R0003564,2024,465700,895700,1361400,31202.0,,87529
R0003568,2024,189600,725750,915350,12703.0,,57643
R0003575,2024,334787,1073900,1408687,22431.0,,90697
R0003578,2024,1922100,1690700,3612800,128781.0,,238373
R0003580,2024,712900,1068000,1780900,44079.0,,115635
R0003583,2024,1974000,1969700,3943700,132258.0,,260543
R0003584,2024,126920,1142280,1269200,8504.0,,81351
R0003590,2024,654100,2117400,2771500,43825.0,,182006
R0003593,2024,1167500,1293700,2461200,78223.0,,161215
R0003594,2024,498400,1064000,1562400,33393.0,,100996
R0003595,2024,413500,1032400,1445900,27705.0,,93190
R0003599,2024,482700,1325200,1807900,32341.0,,117444
R0003600,2024,720400,981000,1701400,48267.0,,110309
R0003602,2024,1108600,1569800,2678400,74277.0,,175768
R0003603,2024,437900,1362100,1800000,29339.0,,116915
R0003607,2024,596700,687000,1283700,39979.0,,82323
R0003610,2024,292800,877800,1170600,19618.0,,74745
R0003613,2024,1524900,1507900,3032800,102168.0,,199513
R0003623,2024,171020,1539180,1710200,11458.0,,110898
R0003630,2024,213100,1231800,1444900,14278.0,,93123
R0003633,2024,735100,1061200,1796300,49252.0,,116667
R0003636,2024,2254500,1860900,4115400,151052.0,,272047
R0003637,2024,807500,1024500,1832000,54103.0,,119059
R0003638,2024,611100,866400,1477500,40944.0,,95308
R0003641,2024,319100,763100,1082200,21380.0,,68822
R0003646,2024,382300,1044900,1427200,25614.0,,91937
R0003649,2024,2268800,1396100,3664900,152010.0,,241863
R0003650,2024,165200,1074300,1239500,7384.0,,79362
R0003651,2024,145700,1104300,1250000,6077.0,,80065
R0003653,2024,1065400,1221600,2287000,71382.0,,149544
R0003655,2024,525900,809100,1335000,35235.0,,85760
R0003666,2024,1055900,967200,2023100,70745.0,,131863
R0003669,2024,1108000,1465100,2573100,74236.0,,168713
R0003670,2024,285300,967700,1253000,15430.0,,80266
R0003671,2024,544900,825500,1370400,36508.0,,88132
R0003672,2024,335100,1155800,1490900,22452.0,,96205
R0003673,2024,322300,1164800,1487100,21594.0,,95951
R0003676,2024,648800,657900,1306700,43470.0,,83864
R0003679,2024,2411500,1626100,4037600,161571.0,,266834
R0003683,2024,3060000,1672600,4732600,205020.0,,313399
R0003686,2024,167800,1078200,1246000,11243.0,,79797
R0003694,2024,1540700,994500,2535200,103227.0,,166173
R0003695,2024,1368300,828600,2196900,91676.0,,143507
R0003696,2024,816000,1007600,1823600,54672.0,,118496
R0003698,2024,2967700,1973500,4941200,198836.0,,327375
R0003710,2024,386700,902300,1289000,25909.0,,82678
R0003711,2024,296900,960800,1257700,19892.0,,80581
R0003712,2024,351700,826500,1178200,23564.0,,75254
R0003713,2024,1067500,827600,1895100,71523.0,,123287
R0003714,2024,882300,736800,1619100,59114.0,,104795
R0003720,2024,324500,1119800,1444300,21742.0,,93083
R0003721,2024,826100,713800,1539900,55349.0,,99488
R0003722,2024,872800,953500,1826300,58478.0,,118677
R0003723,2024,853200,828000,1681200,57164.0,,108955
R0003728,2024,706200,1146100,1852300,47315.0,,120419
R0003731,2024,434500,857400,1291900,29112.0,,82872
R0003733,2024,480400,895600,1376000,32187.0,,88507
R0003735,2024,1014800,831600,1846400,67992.0,,120024
R0003737,2024,282800,820200,1103000,18948.0,,70216
R0003746,2024,1612300,846600,2458900,108024.0,,161061
R0003750,2024,181400,797300,978700,12154.0,,61888
R0003751,2024,644500,1011300,1655800,43182.0,,107254
R0003760,2024,611900,1059800,1671700,40997.0,,108319
R0003766,2024,1051700,1061900,2113600,70464.0,,137926
R0003770,2024,82000,768000,850000,5494.0,,53265
R0003776,2024,191200,1071900,1263100,12810.0,,80943
R0003777,2024,401200,889300,1290500,26880.0,,82779
R0003786,2024,631700,839900,1471600,42324.0,,94912
R0003787,2024,505700,1377500,1883200,33882.0,,122489
R0003789,2024,463300,1013000,1476300,31041.0,,95227
R0003790,2024,402000,988600,1390600,26934.0,,89485
R0003791,2024,636300,735200,1371500,42632.0,,88206
R0003792,2024,660400,990600,1651000,40562.0,,106932
R0003796,2024,118150,1063350,1181500,7916.0,,75476
R0003797,2024,281200,843900,1125100,18840.0,,71697
R0003808,2024,205600,1194400,1400000,10090.0,,90115
R0003811,2024,1356900,1017000,2373900,90912.0,,155366
R0003812,2024,234100,577500,811600,15685.0,,50692
R0003813,2024,227800,1234700,1462500,15263.0,,94303
R0003814,2024,212800,1172300,1385100,14258.0,,89117
R0003815,2024,358000,536900,894900,20301.0,,56273
R0003820,2024,705700,1362100,2067800,47282.0,,134858
R0003821,2024,765600,1034400,1800000,47610.0,,116915
R0003822,2024,124260,1118340,1242600,8325.0,,79569
R0003825,2024,1063600,2017700,3081300,71261.0,,202762
R0003830,2024,388200,1005300,1393500,26009.0,,89680
R0003831,2024,892800,1198400,2091200,59818.0,,136425
R0003832,2024,898300,843500,1741800,60186.0,,113016
R0003833,2024,3325400,3080300,6405700,222802.0,,425497
R0003837,2024,1668000,960800,2628800,111756.0,,172445
R0003839,2024,713300,1148900,1862200,47791.0,,121082
R0003844,2024,866800,801300,1668100,58076.0,,108078
R0003847,2024,989500,1654000,2643500,66297.0,,173430
R0003855,2024,339800,1014500,1354300,22767.0,,87053
R0003858,2024,721600,746600,1468200,48347.0,,94684
R0003860,2024,797900,1040600,1838500,53459.0,,119495
R0003862,2024,1098800,736300,1835100,73620.0,,119267
R0003864,2024,281100,1798500,2079600,18834.0,,135648
R0003867,2024,541400,1354100,1895500,36274.0,,123314
R0003871,2024,320000,679600,999600,21440.0,,63288
R0003873,2024,384900,1340000,1724900,25788.0,,111883
R0003875,2024,426000,882900,1308900,28542.0,,84011
R0003877,2024,193700,895400,1089100,12978.0,,69285
R0003878,2024,333200,997000,1330200,22324.0,,85438
R0003883,2024,1201600,1167800,2369400,80507.0,,155065
R0003895,2024,2921900,1592900,4514800,195767.0,,298807
R0003896,2024,557000,829000,1386000,37319.0,,89177
R0003898,2024,301400,823000,1124400,20194.0,,71650
R0003899,2024,910700,1024200,1934900,61017.0,,125953
R0003901,2024,559800,1040200,1600000,37507.0,,103515
R0003908,2024,1141000,1566400,2707400,76447.0,,177711
R0003909,2024,450000,674900,1124900,30150.0,,71683
R0003910,2024,1378300,1324600,2702900,92346.0,,177409
R0003911,2024,1376500,1622500,2999000,92226.0,,197248
R0003914,2024,629500,1062200,1691700,42177.0,,109659
R0003916,2024,3115600,1237300,4352900,208745.0,,287959
R0003917,2024,1036000,814700,1850700,69412.0,,120312
R0003918,2024,795700,878300,1674000,53312.0,,108473
R0003919,2024,1827900,1855900,3683800,122469.0,,243130
R0003933,2024,759200,850100,1609300,50866.0,,104138
R0003937,2024,644300,959200,1603500,43168.0,,103750
R0003943,2024,1475400,1141100,2616500,98852.0,,171621
R0003945,2024,2080900,1873800,3954700,139420.0,,261280
R0003962,2024,311300,1015700,1327000,20857.0,,85224
R0003970,2024,300800,555600,856400,20154.0,,53694
R0003971,2024,600400,994800,1595200,40227.0,,103193
R0003977,2024,1564900,899500,2464400,104848.0,,161430
R0003983,2024,1268800,1543600,2812400,85010.0,,184746
R0003984,2024,1369200,1464600,2833800,91736.0,,186180
R0003992,2024,1342300,1098700,2441000,89934.0,,159862
R0003996,2024,384300,853800,1238100,25748.0,,79268
R0003999,2024,1256600,911300,2167900,84192.0,,141564
R0004001,2024,706300,772400,1478700,47322.0,,95388
R0004004,2024,123010,1107090,1230100,8242.0,,78732
R0004005,2024,941300,1230200,2171500,63067.0,,141806
R0004006,2024,787200,857000,1644200,52742.0,,106476
R0004013,2024,119150,1072350,1191500,7983.0,,76146
R0004021,2024,1582600,1017400,2600000,106034.0,,170515
R0004024,2024,1746800,1576500,3323300,117036.0,,218976
R0004025,2024,556100,973100,1529200,37259.0,,98771
R0004026,2024,726700,2128900,2855600,48689.0,,187640
R0004027,2024,935000,1352500,2287500,62645.0,,149578
R0004029,2024,373900,1205500,1579400,25051.0,,102135
R0004030,2024,1233600,842200,2075800,78967.0,,135394
R0004031,2024,1236200,1114900,2351100,82825.0,,153839
R0004032,2024,447200,833000,1280200,29962.0,,82088
R0004033,2024,177940,1601460,1779400,11922.0,,115535
R0004034,2024,3144400,2585500,5729900,210675.0,,380218
R0004035,2024,3871000,2220900,6091900,259357.0,,404472
R0004037,2024,233900,1385700,1619600,15671.0,,104828
R0004038,2024,700300,1492700,2193000,46920.0,,143246
R0004040,2024,866100,1124300,1990400,58029.0,,129672
R0004043,2024,1228200,1055100,2283300,78604.0,,149296
R0004050,2024,631700,1039900,1671600,42324.0,,108312
R0004053,2024,1537300,1058000,2595300,102999.0,,170200
R0004054,2024,592800,1433500,2026300,39718.0,,132077
R0004061,2024,857800,1172700,2030500,57473.0,,132359
R0004062,2024,651900,775500,1427400,43677.0,,91951
R0004063,2024,1489900,1064600,2554500,99823.0,,167467
R0004066,2024,424600,1338200,1762800,28448.0,,114423
R0004068,2024,124500,850500,975000,8342.0,,61640
R0004076,2024,1362000,1266100,2628100,91254.0,,172398
R0004077,2024,1186900,1129400,2316300,79522.0,,151507
R0004080,2024,384900,856200,1241100,25788.0,,79469
R0004082,2024,108410,975690,1084100,7263.0,,68950
R0004083,2024,867200,877700,1744900,58102.0,,113223
R0004084,2024,480800,843600,1324400,32214.0,,85050
R0004086,2024,552400,1085000,1637400,37011.0,,106021
R0004090,2024,99000,631899,730899,6633.0,,45285
R0004092,2024,652300,1853900,2506200,43704.0,,164230
R0004093,2024,799200,747500,1546700,53546.0,,99944
R0004096,2024,809600,1132000,1941600,54243.0,,126402
R0004097,2024,921600,834000,1755600,61747.0,,113940
R0004098,2024,181500,792100,973600,12161.0,,61546
R0004100,2024,514100,858000,1372100,34445.0,,88246
R0004101,2024,842300,832600,1674900,56434.0,,108533
R0004103,2024,137200,913900,1051100,9192.0,,66739
R0004112,2024,422100,1018900,1441000,28281.0,,92862
R0004115,2024,558700,1045000,1603700,37433.0,,103763
R0004117,2024,256700,632000,888700,17199.0,,55858
R0004119,2024,1005300,1369400,2374700,67355.0,,155420
R0004125,2024,700600,1089800,1790400,46940.0,,116272
R0004133,2024,303500,455200,758700,16650.0,,47148
R0004135,2024,886100,1018700,1904800,59369.0,,123937
R0004139,2024,543900,1834500,2378400,36441.0,,155668
R0004145,2024,267700,938600,1206300,17936.0,,77137
R0004149,2024,481600,806000,1287600,32267.0,,82584
R0004151,2024,125980,1133820,1259800,8441.0,,80722
R0004152,2024,1215000,1076600,2291600,81405.0,,149852
R0004154,2024,1247700,1148600,2396300,83596.0,,156867
R0004155,2024,1231600,816300,2047900,82517.0,,133524
R0004157,2024,1205500,1091200,2296700,77084.0,,150194
R0004164,2024,386900,1068900,1455800,25922.0,,93854
R0004166,2024,142700,1284300,1427000,9561.0,,91924
R0004167,2024,305000,1166500,1471500,20435.0,,94906
R0004177,2024,2054300,1324200,3378500,133954.0,,222675
R0004178,2024,189900,732200,922100,9039.0,,58096
R0004180,2024,173700,662300,836000,7953.0,,52327
R0004182,2024,241220,2170980,2412200,16162.0,,157932
R0004183,2024,487700,970400,1458100,32676.0,,94008
R0004184,2024,389100,601100,990200,26070.0,,62658
R0004185,2024,340800,729100,1069900,22834.0,,67998
R0004188,2024,1487100,1494300,2981400,99636.0,,196069
R0004190,2024,908900,1929200,2838100,60896.0,,186468
R0004194,2024,4981300,2551900,7533200,333747.0,,501039
R0004202,2024,762600,745700,1508300,51094.0,,97371
R0004207,2024,669200,1193000,1862200,41151.0,,121082
R0004208,2024,2515600,1182700,3698300,168545.0,,244101
R0004210,2024,160320,1442880,1603200,10741.0,,103729
R0004211,2024,1340500,1271500,2612000,89813.0,,171319
R0004222,2024,950000,809900,1759900,63650.0,,114228
R0004224,2024,1198700,877400,2076100,80313.0,,135414
R0004225,2024,985200,831100,1816300,66008.0,,118007
R0004233,2024,402400,1005300,1407700,26961.0,,90631
R0004237,2024,668700,1926500,2595200,44803.0,,170193
R0004238,2024,1110900,1184700,2295600,74430.0,,150120
R0004246,2024,3699200,1637800,5337000,247846.0,,353894
R0004250,2024,2044100,1659200,3703300,136955.0,,244436
R0004251,2024,464500,1956600,2421100,31122.0,,158529
R0004252,2024,752800,1104800,1857600,50438.0,,120774
R0004257,2024,1428700,1592800,3021500,95723.0,,198756
R0004259,2024,1426000,1028900,2454900,95542.0,,160793
R0004264,2024,154530,1390770,1545300,10354.0,,99850
R0004268,2024,437200,931900,1369100,29292.0,,88045
R0004270,2024,928100,1340300,2268400,62183.0,,148298
R0004272,2024,634100,1376000,2010100,42485.0,,130992
R0004276,2024,2632300,1656400,4288700,176364.0,,283658
R0004279,2024,2446000,1850000,4296000,163882.0,,284147
R0004280,2024,815200,1026400,1841600,54618.0,,119702
R0004282,2024,1072600,1132100,2204700,71864.0,,144030
R0004287,2024,219404,1438700,1658104,14700.0,,107408
R0004290,2024,896200,1283800,2180000,60045.0,,142375
R0004292,2024,347800,1038700,1386500,23303.0,,89211
R0004295,2024,109670,987030,1096700,7348.0,,69794
R0004297,2024,1383900,1081900,2465800,92721.0,,161524
R0004304,2024,690900,1667000,2357900,46290.0,,154294
R0004311,2024,1345300,924100,2269400,90135.0,,148365
R0004317,2024,2556800,1712200,4269000,171306.0,,282338
R0004323,2024,391900,2016400,2408300,26257.0,,157671
R0004329,2024,512700,824800,1337500,34351.0,,85928
R0004330,2024,1027200,1023000,2050200,68822.0,,133678
R0004336,2024,124760,1122840,1247600,8359.0,,79904
R0004337,2024,766000,958700,1724700,51322.0,,111870
R0004338,2024,810400,1626500,2436900,54296.0,,159587
R0004345,2024,985500,845200,1830700,66029.0,,118972
R0004346,2024,851900,1993600,2845500,57077.0,,186964
R0004347,2024,331900,1037800,1369700,22237.0,,88085
R0004348,2024,345600,843800,1189400,23155.0,,76005
R0004349,2024,1267800,990400,2258200,84943.0,,147614
R0004350,2024,1270200,1004400,2274600,85103.0,,148713
R0004352,2024,627400,1096900,1724300,42036.0,,111843
R0004354,2024,1229000,1535600,2764600,82343.0,,181543
R0004358,2024,923000,1018000,1941000,61841.0,,126362
R0004363,2024,344400,1019400,1363800,23075.0,,87690
R0004364,2024,173400,1299200,1472600,11618.0,,94979
R0004366,2024,1836100,1202500,3038600,123019.0,,199901
R0004377,2024,644500,1238300,1882800,43182.0,,122463
R0004379,2024,875300,1071900,1947200,58645.0,,126777
R0004381,2024,3506500,1412500,4919000,234936.0,,325888
R0004383,2024,1777600,1100400,2878000,119099.0,,189141
R0004393,2024,113120,1018080,1131200,7579.0,,72105
R0004395,2024,290900,1041800,1332700,19490.0,,85606
R0004396,2024,699500,929100,1628600,46867.0,,105431
R0004398,2024,313100,928700,1241800,17293.0,,79516
R0004407,2024,95330,857970,953300,6387.0,,60186
R0004414,2024,1640700,978300,2619000,109927.0,,171788
R0004415,2024,437200,937300,1374500,29292.0,,88407
R0004417,2024,2363000,1702000,4065000,158321.0,,268670
R0004419,2024,532200,1278500,1810700,35657.0,,117632
R0004428,2024,392200,1235100,1627300,26277.0,,105344
R0004437,2024,568100,1283400,1851500,38063.0,,120366
R0004440,2024,439500,953800,1393300,29447.0,,89666
R0004441,2024,117840,1060560,1178400,7895.0,,75268
R0004442,2024,107380,966420,1073800,7194.0,,68260
R0004445,2024,775900,831300,1607200,51985.0,,103997
R0004450,2024,631000,531900,1162900,42277.0,,74229
R0004451,2024,666900,470200,1137100,44682.0,,72501
R0004453,2024,1075200,1925000,3000200,72038.0,,197328
R0004454,2024,2653700,2303800,4957500,174113.0,,328468
R0004455,2024,502200,846200,1348400,33647.0,,86658
R0004459,2024,1214300,909900,2124200,81358.0,,138636
R0004472,2024,526400,832900,1359300,35269.0,,87388
R0004473,2024,469157,1042800,1511957,31434.0,,97616
R0004480,2024,994800,1094000,2088800,66652.0,,136265
R0004481,2024,172260,1550340,1722600,11541.0,,111729
R0004482,2024,2525900,1951800,4477700,169235.0,,296321
R0004486,2024,695800,2815600,3511400,46619.0,,231579
R0004493,2024,599400,1051400,1650800,40160.0,,106919
R0004497,2024,632600,1044600,1677200,42384.0,,108687
R0004498,2024,214900,549900,764800,10714.0,,47557
R0004500,2024,2903100,2227800,5130900,194508.0,,340085
R0004501,2024,224880,2023920,2248800,15067.0,,146985
R0004502,2024,886400,761300,1647700,59389.0,,106711
R0004503,2024,1927900,1904800,3832700,129170.0,,253106
R0004508,2024,567000,1156200,1723200,37989.0,,111769
R0004512,2024,530400,661600,1192000,31852.0,,76179
R0004513,2024,431500,1016000,1447500,28911.0,,93298
R0004516,2024,1242300,1580300,2822600,83234.0,,185429
R0004519,2024,867600,1841400,2709000,58129.0,,177818
R0004520,2024,795300,854500,1649800,53285.0,,106852
R0004521,2024,280700,1575500,1856200,18807.0,,120680
R0004522,2024,539400,1010600,1550000,36140.0,,100165
R0004523,2024,168900,1031700,1200600,11316.0,,76755
R0004524,2024,581900,974100,1556000,38987.0,,100567
R0004525,2024,562300,1360200,1922500,37674.0,,125123
R0004528,2024,543000,941400,1484400,36381.0,,95770
R0004529,2024,364900,842900,1207800,24448.0,,77238
R0004532,2024,170470,1534230,1704700,11421.0,,110530
R0004540,2024,735300,636900,1372200,49265.0,,88252
R0004547,2024,78260,704340,782600,5244.0,,48749
R0004548,2024,708400,763900,1472300,47463.0,,94959
R0004559,2024,496000,874300,1370300,33232.0,,88125
R0004566,2024,750700,1866300,2617000,50297.0,,171654
R0004569,2024,986000,852000,1838000,66062.0,,119461
R0004585,2024,894200,1059200,1953400,59911.0,,127193
R0004593,2024,544400,1936000,2480400,36475.0,,162502
R0004598,2024,1395300,1726100,3121400,93485.0,,205449
R0004603,2024,379300,569000,948300,21728.0,,59851
R0004605,2024,1119700,809200,1928900,75020.0,,125551
R0004617,2024,862100,1131400,1993500,57761.0,,129880
R0004620,2024,734500,924900,1659400,49212.0,,107495
R0004621,2024,266130,2395170,2661300,17831.0,,174622
R0004624,2024,194600,1062000,1256600,13038.0,,80507
R0004625,2024,608700,807900,1416600,40783.0,,91227
R0004627,2024,93610,842490,936100,6272.0,,59034
R0004628,2024,740000,750800,1490800,49580.0,,96199
R0004631,2024,190000,1710000,1900000,9045.0,,123615
R0004632,2024,89350,804150,893500,5987.0,,56180
R0004634,2024,138230,1244070,1382300,9261.0,,88929
R0004635,2024,946700,1099100,2045800,63429.0,,133384
R0004638,2024,360400,699000,1059400,24147.0,,67295
R0004640,2024,573400,826500,1399900,38418.0,,90108
R0004643,2024,206430,1857870,2064300,13831.0,,134623
R0004649,2024,468200,1370400,1838600,31369.0,,119501
R0004654,2024,119510,1075590,1195100,8007.0,,76387
R0004655,2024,111700,1005300,1117000,7484.0,,71154
R0004656,2024,1997700,1806500,3804200,133846.0,,251196
R0004659,2024,262480,2362320,2624800,17586.0,,172177
R0004660,2024,282900,2546100,2829000,18954.0,,185858
R0004664,2024,362300,1169600,1531900,24274.0,,98952
R0004672,2024,473900,989400,1463300,31751.0,,94356
R0004673,2024,1216000,1213300,2429300,81472.0,,159078
R0004674,2024,738200,1107400,1845600,45774.0,,119970
R0004675,2024,836600,1570100,2406700,56052.0,,157564
R0004681,2024,527800,1121200,1649000,35363.0,,106798
R0004683,2024,141110,1269990,1411100,9454.0,,90859
R0004685,2024,382900,895100,1278000,25654.0,,81941
R0004687,2024,184100,917100,1101200,12335.0,,70095
R0004688,2024,556200,673400,1229600,37265.0,,78698
R0004693,2024,916100,1367400,2283500,61379.0,,149310
R0004698,2024,366700,1047100,1413800,20884.0,,91040
R0004707,2024,760900,756400,1517300,50980.0,,97974
R0004713,2024,143960,1295640,1439600,9645.0,,92768
R0004714,2024,636700,908900,1545600,42659.0,,99870
R0004719,2024,1966300,2013400,3979700,131742.0,,262955
R0004720,2024,804500,1568500,2373000,53902.0,,155306
R0004722,2024,993900,1728700,2722600,66591.0,,178729
R0004728,2024,296300,1078000,1374300,19852.0,,88393
R0004729,2024,804500,1945500,2750000,53901.0,,180565
R0004730,2024,1109300,811800,1921100,74323.0,,125029
R0004731,2024,78575,566650,645225,5265.0,,41388
R0004733,2024,45963,301125,347088,3080.0,,21412
R0004734,2024,1673600,1817000,3490600,112131.0,,230185
R0004738,2024,830100,814600,1644700,55617.0,,106510
R0004739,2024,239800,661900,901700,16067.0,,56729
R0004745,2024,466500,1015400,1481900,31256.0,,95602
R0004746,2024,860600,1562900,2423500,57660.0,,158690
R0004748,2024,183400,853100,1036500,12288.0,,65761
R0004751,2024,2419300,1597200,4016500,162093.0,,265421
R0004755,2024,1324200,4310900,5635100,88721.0,,373867
R0004756,2024,696300,1918000,2614300,46652.0,,171473
R0004760,2024,164200,926700,1090900,11001.0,,69405
R0004761,2024,1196000,1911400,3107400,80132.0,,204511
R0004773,2024,901300,902000,1803300,60387.0,,117136
R0004774,2024,1010100,836300,1846400,67677.0,,120024
R0004777,2024,135450,1219050,1354500,9075.0,,87067
R0004784,2024,549400,593600,1143000,33125.0,,72896
R0004787,2024,582501,915400,1497901,39027.0,,96674
R0004788,2024,55886,1147000,1202886,3744.0,,76908
R0004794,2024,683800,931100,1614900,45815.0,,104513
R0004795,2024,1134900,1467800,2602700,76038.0,,170696
R0004796,2024,328800,1186100,1514900,22030.0,,97813
R0004799,2024,535200,820800,1356000,35858.0,,87167
R0004803,2024,190230,1712070,1902300,12745.0,,123769
R0004810,2024,491700,964800,1456500,32944.0,,93901
R0004816,2024,1542900,895400,2438300,103374.0,,159681
R0004817,2024,1037300,1839300,2876600,69499.0,,189047
R0004818,2024,629000,671000,1300000,42143.0,,83415
R0004819,2024,365900,1011400,1377300,24516.0,,88594
R0004838,2024,540900,664100,1205000,36240.0,,77050
R0004840,2024,778600,821900,1600500,52166.0,,103549
R0004843,2024,1315000,1842700,3157700,88105.0,,207881
R0004851,2024,1459500,1806600,3266100,97787.0,,215144
R0004852,2024,390900,1078400,1469300,26190.0,,94758
R0004854,2024,2059400,1696900,3756300,137980.0,,247987
R0004858,2024,438600,1005100,1443700,29386.0,,93043
R0004859,2024,288200,1060700,1348900,15624.0,,86691
R0004866,2024,1276400,1118400,2394800,85519.0,,156767
R0004873,2024,135380,1218420,1353800,9070.0,,87020
R0004875,2024,251900,950300,1202200,13192.0,,76862
R0004876,2024,481100,721600,1202700,28549.0,,76896
R0004877,2024,455900,1182700,1638600,30545.0,,106101
R0004878,2024,482200,999600,1481800,32307.0,,95596
R0004879,2024,777500,1503300,2280800,52093.0,,149129
R0004883,2024,187500,948300,1135800,12563.0,,72414
R0004884,2024,402900,1202400,1605300,26994.0,,103870
R0004888,2024,1081300,951300,2032600,72447.0,,132499
R0004894,2024,693000,1329400,2022400,46431.0,,131816
R0004895,2024,402800,1106000,1508800,26988.0,,97405
R0004896,2024,360800,744000,1104800,24174.0,,70337
R0004897,2024,1303700,1233400,2537100,87348.0,,166301
R0004898,2024,2247300,1198900,3446200,150569.0,,227210
R0004899,2024,516900,825800,1342700,34632.0,,86276
R0004902,2024,374400,1724900,2099300,25085.0,,136968
R0004906,2024,162090,1458810,1620900,10860.0,,104915
R0004907,2024,788300,948900,1737200,52816.0,,112707
R0004911,2024,450700,840900,1291600,30197.0,,82852
R0004913,2024,204400,829600,1034000,13695.0,,65593
R0004915,2024,475800,978000,1453800,31879.0,,93720
R0004920,2024,1526000,796700,2322700,102242.0,,151936
R0004921,2024,688900,759600,1448500,46156.0,,93365
R0004927,2024,179700,1605500,1785200,12040.0,,115923
R0004929,2024,326400,2515600,2842000,21869.0,,186729
R0004930,2024,139000,732700,871700,9313.0,,54719
R0004932,2024,1032300,778600,1810900,69164.0,,117645
R0004933,2024,1433900,970100,2404000,96071.0,,157383
R0004935,2024,256500,873000,1129500,17186.0,,71992
R0004936,2024,1201600,1225800,2427400,80507.0,,158951
R0004938,2024,631000,846700,1477700,42277.0,,95321
R0004943,2024,386800,1739800,2126600,25916.0,,138797
R0004946,2024,1586200,854500,2440700,106275.0,,159842
R0004952,2024,2314800,2269500,4584300,155092.0,,303463
R0004953,2024,885900,834000,1719900,59355.0,,111548
R0004957,2024,933100,692300,1625400,62518.0,,105217
R0004958,2024,2148500,992000,3140500,143950.0,,206729
R0004959,2024,2306000,1657700,3963700,154502.0,,261883
R0004960,2024,689900,873600,1563500,46223.0,,101070
R0004962,2024,3282200,2488700,5770900,219907.0,,382965
R0004963,2024,1478100,1806300,3284400,99033.0,,216370
R0004964,2024,691100,1100800,1791900,46304.0,,116372
R0004966,2024,414000,816200,1230200,27738.0,,78738
R0004971,2024,1188400,1657700,2846100,79623.0,,187004
R0004973,2024,769700,759900,1529600,51570.0,,98798
R0004974,2024,776900,923200,1700100,52052.0,,110222
R0004980,2024,522200,984600,1506800,34987.0,,97271
R0004981,2024,505000,1046000,1551000,33835.0,,100232
R0004983,2024,2171900,2734500,4906400,145517.0,,325044
R0004985,2024,821900,795700,1617600,55067.0,,104694
R0004990,2024,645000,1552500,2197500,43215.0,,143548
R0004991,2024,535100,1106000,1641100,32167.0,,106269
R0004994,2024,810100,938300,1748400,54277.0,,113458
R0004996,2024,3541000,2895000,6436000,237247.0,,427527
R0005001,2024,187400,755900,943300,12556.0,,59516
R0005004,2024,1454700,972900,2427600,97465.0,,158964
R0005005,2024,1013700,1487800,2501500,67918.0,,163916
R0005007,2024,704600,1129200,1833800,47208.0,,119180
R0005022,2024,83520,751680,835200,5596.0,,52273
R0005026,2024,1139500,930900,2070400,76347.0,,135032
R0005029,2024,1048900,1360300,2409200,70276.0,,157731
R0005031,2024,104500,920094,1024594,7002.0,,64963
R0005042,2024,485000,1461600,1946600,32495.0,,126737
R0005044,2024,369400,560800,930200,24750.0,,58638
R0005045,2024,976500,1148200,2124700,65426.0,,138670
R0005054,2024,391900,845900,1237800,26257.0,,79248
R0005055,2024,740900,1681600,2422500,49640.0,,158623
R0005058,2024,207400,1450700,1658100,13896.0,,107408
R0005065,2024,895300,915000,1810300,59985.0,,117605
R0005066,2024,496000,1102900,1598900,33232.0,,103441
R0005073,2024,647000,1067000,1714000,43349.0,,111153
R0005078,2024,1755000,1645000,3400000,117586.0,,224115
R0005080,2024,628400,914600,1543000,42103.0,,99696
R0005081,2024,560000,959000,1519000,37520.0,,98088
R0005082,2024,536500,918500,1455000,35946.0,,93800
R0005085,2024,633100,1441300,2074400,42418.0,,135300
R0005087,2024,454800,913400,1368200,30472.0,,87984
R0005090,2024,274300,877100,1151400,18378.0,,73459
R0005093,2024,835900,1042600,1878500,56005.0,,122175
R0005094,2024,2722200,1916300,4638500,182387.0,,307095
R0005095,2024,1093800,1795300,2889100,73285.0,,189885
R0005098,2024,3141000,1958100,5099100,210447.0,,337955
R0005099,2024,125300,1127700,1253000,8395.0,,80266
R0005106,2024,293200,1041400,1334600,19644.0,,85733
R0005109,2024,646104,1115300,1761404,43289.0,,114329
R0005119,2024,1816700,745500,2562200,121719.0,,167982
R0005120,2024,1148600,1700600,2849200,76956.0,,187211
R0005121,2024,395200,894800,1290000,26478.0,,82745
R0005122,2024,83800,720500,804300,5615.0,,50203
R0005124,2024,478400,1135100,1613500,32053.0,,104420
R0005125,2024,148000,946800,1094800,9916.0,,69667
R0005127,2024,297300,931100,1228400,16234.0,,78618
R0005128,2024,1254900,831200,2086100,84078.0,,136084
R0005132,2024,1239400,953200,2192600,79355.0,,143219
R0005135,2024,2576500,1824400,4400900,172626.0,,291175
R0005140,2024,1465500,2360300,3825800,98189.0,,252644
R0005143,2024,479300,896900,1376200,32113.0,,88520
R0005144,2024,104920,944280,1049200,7030.0,,66611
R0005145,2024,496700,673500,1170200,33279.0,,74718
R0005153,2024,1128800,1277400,2406200,75630.0,,157530
R0005158,2024,882300,1146000,2028300,59114.0,,132211
R0005162,2024,472000,1783200,2255200,31624.0,,147413
R0005164,2024,412000,802200,1214200,27604.0,,77666
R0005165,2024,250300,850700,1101000,16770.0,,70082
R0005166,2024,244200,1462600,1706800,16361.0,,110671
R0005167,2024,178380,1605420,1783800,11951.0,,115830
R0005176,2024,506800,833600,1340400,33956.0,,86122
R0005185,2024,485800,1035100,1520900,32549.0,,98215
R0005190,2024,387100,1354300,1741400,25936.0,,112989
R0005191,2024,368900,1001000,1369900,24716.0,,88098
R0005195,2024,681300,1149700,1831000,41962.0,,118992
R0005208,2024,172500,1093700,1266200,11558.0,,81150
R0005210,2024,1617200,1618400,3235600,108352.0,,213100
R0005211,2024,322300,642700,965000,21594.0,,60970
R0005213,2024,1179000,1740700,2919700,78993.0,,191935
R0005216,2024,172950,1556550,1729500,11588.0,,112192
R0005219,2024,2395400,1700700,4096100,160492.0,,270754
R0005220,2024,3029800,1702500,4732300,202997.0,,313379
R0005221,2024,1118300,1683900,2802200,74926.0,,184062
R0005222,2024,167030,1503270,1670300,11191.0,,108225
R0005226,2024,358200,829500,1187700,23999.0,,75891
R0005229,2024,137551,964900,1102451,5531.0,,70179
R0005232,2024,898800,1048200,1947000,60220.0,,126764
R0005233,2024,598000,882500,1480500,40066.0,,95509
R0005240,2024,834600,837900,1672500,55918.0,,108373
R0005243,2024,1175600,869100,2044700,78765.0,,133310
R0005246,2024,382600,773100,1155700,21949.0,,73747
R0005252,2024,285600,1026900,1312500,15451.0,,84253
R0005253,2024,1877200,1121800,2999000,125772.0,,197248
R0005256,2024,1200100,906400,2106500,80407.0,,137451
R0005258,2024,518300,547400,1065700,34726.0,,67717
R0005263,2024,1035900,974200,2010100,69405.0,,130992
R0005264,2024,878000,956900,1834900,58826.0,,119253
R0005270,2024,369600,689300,1058900,24763.0,,67261
R0005274,2024,1113800,2442800,3556600,74625.0,,234607
R0005275,2024,604200,600100,1204300,40481.0,,77003
R0005276,2024,1158500,2275800,3434300,77620.0,,226413
R0005277,2024,520300,812100,1332400,34860.0,,85586
R0005278,2024,1167300,821100,1988400,78210.0,,129538
R0005279,2024,472600,1108500,1581100,31664.0,,102249
R0005280,2024,997500,1329100,2326600,66833.0,,152197
R0005283,2024,1605200,1814900,3420100,107548.0,,225462
R0005284,2024,657600,1555000,2212600,44059.0,,144559
R0005288,2024,756100,1019800,1775900,50659.0,,115300
R0005289,2024,186600,1349000,1535600,12502.0,,99200
R0005290,2024,1051600,958700,2010300,70457.0,,131005
R0005292,2024,315400,473200,788600,17447.0,,49151
R0005294,2024,2220000,1943200,4163200,148740.0,,275249
R0005296,2024,537600,749900,1287500,36019.0,,82578
R0005302,2024,1725000,1002900,2727900,115575.0,,179084
R0005307,2024,111580,1004220,1115800,7476.0,,71074
R0005308,2024,288800,915200,1204000,19350.0,,76983
R0005310,2024,468100,711300,1179400,31363.0,,75335
R0005311,2024,454300,673200,1127500,30438.0,,71858
R0005312,2024,245900,1381400,1627300,16475.0,,105344
R0005322,2024,1532000,2695800,4227800,102644.0,,279578
R0005339,2024,623850,1047500,1671350,41798.0,,108295
R0005340,2024,631600,947300,1578900,38632.0,,102101
R0005341,2024,125760,1131840,1257600,8426.0,,80574
R0005348,2024,776500,1113000,1889500,52026.0,,122912
R0005351,2024,671700,1056200,1727900,45004.0,,112084
R0005357,2024,2500600,1187100,3687700,167540.0,,243391
R0005364,2024,1324400,1384700,2709100,88735.0,,177825
R0005365,2024,762400,801300,1563700,51081.0,,101083
R0005366,2024,297700,569500,867200,19946.0,,54417
R0005367,2024,775600,1488500,2264100,51965.0,,148010
R0005372,2024,1469500,1232300,2701800,98457.0,,177336
R0005376,2024,494300,890700,1385000,33118.0,,89110
R0005378,2024,677500,838500,1516000,45393.0,,97887
R0005389,2024,298300,1221000,1519300,19986.0,,98108
R0005395,2024,23826,834930,858756,1596.0,,53852
R0005398,2024,2541500,1972400,4513900,170281.0,,298746
R0005403,2024,933700,1183200,2116900,62558.0,,138147
R0005404,2024,242700,855800,1098500,16261.0,,69915
R0005407,2024,831100,2495700,3326800,55684.0,,219211
R0005408,2024,399300,1029000,1428300,26753.0,,92011
R0005409,2024,506900,632000,1138900,33962.0,,72621
R0005418,2024,1406900,931300,2338200,94262.0,,152974
R0005422,2024,672400,760400,1432800,45051.0,,92313
R0005426,2024,2992700,2495300,5488000,200511.0,,364011
R0005436,2024,3248500,4572900,7821400,217650.0,,520349
R0005439,2024,1159200,626800,1786000,77666.0,,115977
R0005440,2024,3656900,3552600,7209500,245012.0,,479352
R0005442,2024,426900,775300,1202200,28602.0,,76862
R0005443,2024,1845700,1049700,2895400,123662.0,,190307
R0005444,2024,395400,1657300,2052700,26492.0,,133846
R0005452,2024,484400,423400,907800,32455.0,,57138
R0005457,2024,105000,1303000,1408000,7035.0,,90651
R0005459,2024,665600,843000,1508600,44595.0,,97391
R0005462,2024,918800,1032300,1951100,61560.0,,127039
R0005463,2024,141700,910600,1052300,9494.0,,66819
R0005478,2024,293800,1830200,2124000,19685.0,,138623
R0005484,2024,834300,1675900,2510200,55898.0,,164498
R0005485,2024,98110,882990,981100,6573.0,,62049
R0005486,2024,428000,1039900,1467900,28676.0,,94664
R0005487,2024,2570400,2152300,4722700,172217.0,,312736
R0005494,2024,570100,1640000,2210100,38197.0,,144392
R0005496,2024,346900,935700,1282600,23242.0,,82249
R0005501,2024,1366700,1132100,2498800,91569.0,,163735
R0005504,2024,841400,2024000,2865400,56374.0,,188297
R0005505,2024,1365000,838500,2203500,91455.0,,143950
R0005506,2024,412400,685000,1097400,27631.0,,69841
R0005508,2024,590000,574500,1164500,39530.0,,74337
R0005509,2024,396600,1070800,1467400,26572.0,,94631
R0005510,2024,3379300,1383200,4762500,226413.0,,315403
R0005513,2024,723600,892200,1615800,48481.0,,104574
R0005518,2024,300900,707900,1008800,20160.0,,63905
R0005522,2024,211100,768200,979300,14144.0,,61928
R0005523,2024,641700,962600,1604300,39309.0,,103803
R0005534,2024,967700,838500,1806200,64836.0,,117330
R0005536,2024,1152200,2185900,3338100,77197.0,,219968
R0005538,2024,372300,1348100,1720400,24944.0,,111582
R0005539,2024,211070,1899630,2110700,14142.0,,137732
R0005543,2024,476000,848800,1324800,31892.0,,85077
R0005544,2024,92470,832230,924700,6195.0,,58270
R0005546,2024,224430,2019870,2244300,15037.0,,146683
R0005550,2024,1002000,1009400,2011400,67134.0,,131079
R0005556,2024,844600,1081500,1926100,56588.0,,125364
R0005557,2024,165730,1491570,1657300,11104.0,,107354
R0005560,2024,478000,942000,1420000,32026.0,,91455
R0005565,2024,518900,1078700,1597600,34766.0,,103354
R0005580,2024,909400,1682100,2591500,60930.0,,169946
R0005581,2024,425400,965400,1390800,28502.0,,89499
R0005585,2024,989700,887900,1877600,66310.0,,122114
R0005588,2024,1069300,1032200,2101500,71643.0,,137116
R0005589,2024,692100,920800,1612900,46371.0,,104379
R0005591,2024,1190000,956700,2146700,79730.0,,140144
R0005597,2024,521700,942200,1463900,34954.0,,94396
R0005610,2024,2311500,1267600,3579100,154871.0,,236115
R0005612,2024,1187700,1013400,2201100,79576.0,,143789
R0005613,2024,311800,1159900,1471700,20891.0,,94919
R0005619,2024,730500,839700,1570200,48944.0,,101518
R0005624,2024,646600,921800,1568400,43322.0,,101398
R0005627,2024,241400,1075700,1317100,16174.0,,84561
R0005628,2024,1323400,668400,1991800,88668.0,,129766
R0005633,2024,476700,845300,1322000,31939.0,,84889
R0005635,2024,421600,1638000,2059600,28247.0,,134308
R0005640,2024,352200,611300,963500,23597.0,,60870
R0005646,2024,1421800,1608200,3030000,95261.0,,199325
R0005647,2024,854500,701400,1555900,57252.0,,100560
R0005653,2024,214600,871600,1086200,14378.0,,69090
R0005656,2024,658900,691400,1350300,44146.0,,86785
R0005657,2024,171300,1046900,1218200,11477.0,,77934
R0005659,2024,270010,2430090,2700100,18091.0,,177222
R0005660,2024,307500,1600600,1908100,16918.0,,124158
R0005664,2024,535400,862700,1398100,35872.0,,89988
R0005665,2024,318300,1149900,1468200,21326.0,,94684
R0005668,2024,649700,493500,1143200,43530.0,,72909
R0005671,2024,339900,1076000,1415900,22773.0,,91180
R0005672,2024,2522900,1130700,3653600,169034.0,,241106
R0005675,2024,1211100,845100,2056200,81144.0,,134080
R0005679,2024,2528700,2689200,5217900,165738.0,,345914
R0005685,2024,331800,784400,1116200,22231.0,,71100
R0005689,2024,992500,1869300,2861800,66498.0,,188056
R0005690,2024,130100,881300,1011400,5032.0,,64079
R0005696,2024,193800,910000,1103800,12985.0,,70270
R0005701,2024,348200,522200,870400,19645.0,,54632
R0005702,2024,1350600,838300,2188900,90490.0,,142971
R0005703,2024,1070500,848700,1919200,71724.0,,124901
R0005704,2024,663100,833100,1496200,44428.0,,96560
R0005705,2024,1098500,696100,1794600,73600.0,,116553
R0005708,2024,1819700,1091800,2911500,121920.0,,191386
R0005709,2024,241400,1007600,1249000,12489.0,,79998
R0005711,2024,730400,1689000,2419400,48937.0,,158415
R0005714,2024,2389600,1418800,3808400,160103.0,,251478
R0005716,2024,540300,845400,1385700,36200.0,,89157
R0005717,2024,717000,2993400,3710400,48039.0,,244912
R0005719,2024,429600,1117500,1547100,28783.0,,99971
R0005720,2024,183900,1360000,1543900,12321.0,,99756
R0005724,2024,1122800,1370700,2493500,75228.0,,163380
R0005725,2024,369400,819400,1188800,24750.0,,75965
R0005732,2024,600400,735800,1336200,40227.0,,85840
R0005733,2024,1571700,1445100,3016800,105304.0,,198441
R0005734,2024,295800,1149900,1445700,19819.0,,93177
R0005738,2024,862900,1048300,1911200,57814.0,,124365
R0005741,2024,648000,1207800,1855800,43416.0,,120654
R0005744,2024,455800,1079900,1535700,30539.0,,99207
R0005745,2024,823100,976200,1799300,55148.0,,116868
R0005747,2024,530000,842300,1372300,35510.0,,88259
R0005750,2024,439300,901500,1340800,29433.0,,86149
R0005751,2024,731700,974700,1706400,49024.0,,110644
R0005757,2024,740000,1067600,1807600,49580.0,,117424
R0005758,2024,665900,960400,1626300,44615.0,,105277
R0005759,2024,729500,791300,1520800,45192.0,,98209
R0005760,2024,940500,898300,1838800,63014.0,,119515
R0005762,2024,1225900,1064300,2290200,82135.0,,149758
R0005764,2024,662200,840800,1503000,44367.0,,97016
R0005768,2024,434400,904300,1338700,29105.0,,86008
R0005770,2024,1298200,1824900,3123100,86979.0,,205563
R0005773,2024,600100,860000,1460100,40207.0,,94142
R0005775,2024,1044600,1805300,2849900,69988.0,,187258
R0005777,2024,137710,1239390,1377100,9227.0,,88581
R0005779,2024,361400,931500,1292900,20528.0,,82939
R0005780,2024,378500,1400400,1778900,25360.0,,115501
R0005782,2024,122700,1415500,1538200,8221.0,,99374
R0005786,2024,374900,803700,1178600,25118.0,,75281
R0005787,2024,328800,874100,1202900,22030.0,,76909
R0005788,2024,637200,1192600,1829800,42692.0,,118912
R0005794,2024,2835900,1783800,4619700,190005.0,,305835
R0005796,2024,780400,872900,1653300,52287.0,,107086
R0005804,2024,880400,831800,1712200,58987.0,,111032
R0005808,2024,871400,832800,1704200,58384.0,,110496
R0005809,2024,412300,507600,919900,27624.0,,57948
R0005812,2024,203500,1831500,2035000,13635.0,,132660
R0005815,2024,112310,1010790,1123100,7525.0,,71563
R0005816,2024,654700,683000,1337700,43865.0,,85941
R0005820,2024,492400,1059100,1551500,32991.0,,100266
R0005822,2024,191500,1077600,1269100,12830.0,,81345
R0005824,2024,783800,1166800,1950600,52515.0,,127005
R0005825,2024,1773000,873700,2646700,118791.0,,173644
R0005830,2024,658200,960800,1619000,44099.0,,104788
R0005836,2024,715000,971700,1686700,47905.0,,109324
R0005837,2024,626700,889100,1515800,41989.0,,97874
R0005838,2024,539500,818600,1358100,36147.0,,87308
R0005839,2024,1493200,2204200,3697400,100044.0,,244041
R0005843,2024,1039500,1582300,2621800,69647.0,,171976
R0005845,2024,659700,1065700,1725400,44200.0,,111917
R0005846,2024,334400,985300,1319700,22405.0,,84735
R0005853,2024,356000,778400,1134400,23852.0,,72320
R0005854,2024,401400,932500,1333900,26894.0,,85686
R0005858,2024,4910100,1580200,6490300,328977.0,,431165
R0005860,2024,963600,1228400,2192000,64561.0,,143179
R0005865,2024,204400,995600,1200000,13695.0,,76715
R0005867,2024,345300,1037400,1382700,23135.0,,88956
R0005877,2024,851100,987900,1839000,57024.0,,119528
R0005879,2024,530700,865300,1396000,31872.0,,89847
R0005880,2024,3002700,1465900,4468600,201181.0,,295711
R0005886,2024,1253100,973600,2226700,83958.0,,145504
R0005890,2024,194500,1022100,1216600,13032.0,,77827
R0005896,2024,377800,909700,1287500,25313.0,,82578
R0005897,2024,873300,678500,1551800,58511.0,,100286
R0005898,2024,966600,774800,1741400,64762.0,,112989
R0005899,2024,1462800,1128300,2591100,98008.0,,169919
R0005902,2024,209700,817300,1027000,14050.0,,65124
R0005903,2024,1176600,1663700,2840300,78832.0,,186615
R0005914,2024,1225700,1018600,2244300,82122.0,,146683
R0005916,2024,608400,926600,1535000,40763.0,,99160
R0005920,2024,441500,624900,1066400,29581.0,,67764
R0005921,2024,1188700,1918900,3107600,79643.0,,204524
R0005922,2024,4781000,1886100,6667100,320327.0,,443011
R0005926,2024,790800,989500,1780300,52984.0,,115595
R0005928,2024,441500,1612000,2053500,29581.0,,133900
R0005942,2024,1287800,976800,2264600,86283.0,,148043
R0005944,2024,1385900,1066100,2452000,92855.0,,160599
R0005946,2024,2115200,1322100,3437300,141718.0,,226614
R0005948,2024,894800,909100,1803900,59952.0,,117176
R0005950,2024,1966800,3295200,5262000,131776.0,,348869
R0005952,2024,786500,1102000,1888500,52696.0,,122845
R0005953,2024,243100,852900,1096000,16288.0,,69747
R0005955,2024,207600,1155600,1363200,13909.0,,87649
R0005956,2024,509400,729700,1239100,34130.0,,79335
R0005964,2024,587900,841600,1429500,39389.0,,92092
R0005967,2024,3141500,1238800,4380300,210481.0,,289795
R0005978,2024,566501,1037900,1604401,37956.0,,103810
R0005983,2024,1501900,1898700,3400600,100627.0,,224155
R0005984,2024,1611500,1565500,3177000,107971.0,,209174
R0005985,2024,2909700,1838500,4748200,194950.0,,314444
R0005991,2024,532300,734200,1266500,35664.0,,81171
R0005995,2024,746900,1020200,1767100,50042.0,,114711
R0005996,2024,2371300,1049600,3420900,158877.0,,225515
R0006001,2024,682400,837400,1519800,45721.0,,98142
R0006003,2024,2714800,2132300,4847100,181892.0,,321071
R0006010,2024,139850,1258650,1398500,9370.0,,90015
R0006012,2024,146600,1105100,1251700,9822.0,,80179
R0006014,2024,312500,1690800,2003300,20938.0,,130536
R0006020,2024,632600,661100,1293700,42384.0,,82993
R0006027,2024,179300,1058400,1237700,12013.0,,79241
R0006029,2024,1239600,895500,2135100,83053.0,,139367
R0006031,2024,780300,1375200,2155500,52280.0,,140734
R0006032,2024,127750,1149750,1277500,8559.0,,81908
R0006038,2024,1625200,2339400,3964600,108888.0,,261943
R0006040,2024,7037300,4231600,11268900,471499.0,,751331
R0006043,2024,691500,1133600,1825100,46331.0,,118597
R0006047,2024,852800,896000,1748800,57138.0,,113485
R0006053,2024,1248600,1183500,2432100,83656.0,,159266
R0006056,2024,228480,2056320,2284800,15308.0,,149397
R0006059,2024,223400,514500,737900,14968.0,,45754
R0006064,2024,698000,939000,1637000,46766.0,,105994
R0006067,2024,764400,842000,1606400,51215.0,,103944
R0006068,2024,1053600,1141300,2194900,70591.0,,143373
R0006072,2024,364000,969600,1333600,24388.0,,85666
R0006074,2024,549700,777400,1327100,36830.0,,85231
R0006076,2024,319700,816700,1136400,21420.0,,72454
R0006077,2024,609200,1036100,1645300,40817.0,,106550
R0006079,2024,703100,836100,1539200,47108.0,,99441
R0006086,2024,695800,1040700,1736500,46619.0,,112661
R0006087,2024,5189274,2060200,7249474,347681.0,,482030
R0006089,2024,384600,906100,1290700,25768.0,,82792
R0006090,2024,571100,752900,1324000,38264.0,,85023
R0006092,2024,1684500,1110500,2795000,112862.0,,183580
R0006095,2024,1729400,1984800,3714200,115870.0,,245166
R0006097,2024,641600,1217500,1859100,42987.0,,120875
R0006100,2024,193600,647900,841500,12971.0,,52696
R0006101,2024,122800,773600,896400,8228.0,,56374
R0006106,2024,1364900,1260400,2625300,91448.0,,172210
R0006109,2024,556000,1400400,1956400,37252.0,,127394
R0006117,2024,294700,1020200,1314900,19745.0,,84413
R0006118,2024,451500,1693300,2144800,30251.0,,140017
R0006121,2024,446500,828200,1274700,29916.0,,81720
R0006122,2024,592000,866300,1458300,35979.0,,94021
R0006127,2024,1066500,1113800,2180300,71456.0,,142395
R0006129,2024,379300,1049500,1428800,25413.0,,92045
R0006132,2024,337500,698000,1035500,22613.0,,65694
R0006133,2024,870700,700800,1571500,58337.0,,101606
R0006134,2024,1225800,845700,2071500,82129.0,,135106
R0006135,2024,497200,700000,1197200,33312.0,,76527
R0006137,2024,846500,1248300,2094800,56716.0,,136667
R0006138,2024,145520,1309680,1455200,9750.0,,93813
R0006140,2024,302700,866700,1169400,20281.0,,74665
R0006141,2024,596900,1034800,1631700,39992.0,,105639
R0006148,2024,1688400,1508900,3197300,113123.0,,210534
R0006149,2024,103100,927900,1031000,6908.0,,65392
R0006151,2024,379300,993900,1373200,25413.0,,88319
R0006152,2024,4667400,2432600,7100000,312716.0,,472015
R0006154,2024,102010,918090,1020100,6835.0,,64662
R0006155,2024,1338150,1276500,2614650,89656.0,,171497
R0006156,2024,1231100,960500,2191600,82484.0,,143152
R0006160,2024,1319300,1022900,2342200,88393.0,,153242
R0006161,2024,516400,833300,1349700,34599.0,,86745
R0006165,2024,511790,4606110,5117900,34290.0,,339214
R0006166,2024,140560,1265040,1405600,9418.0,,90490
R0006172,2024,837200,875300,1712500,56092.0,,111053
R0006173,2024,1675200,1097800,2773000,108553.0,,182106
R0006174,2024,409400,1352900,1762300,27430.0,,114389
R0006175,2024,350700,1656300,2007000,23497.0,,130784
R0006176,2024,474200,574500,1048700,31771.0,,66578
R0006177,2024,641700,1158300,1800000,42994.0,,116915
R0006179,2024,880300,840600,1720900,58980.0,,111615
R0006180,2024,1100400,1057400,2157800,73727.0,,140888
R0006182,2024,1211800,1033200,2245000,81191.0,,146730
R0006183,2024,448100,816000,1264100,30023.0,,81010
R0006184,2024,1400200,1339000,2739200,93813.0,,179841
R0006187,2024,1070000,806800,1876800,71690.0,,122061
R0006190,2024,855500,1003800,1859300,57319.0,,120888
R0006191,2024,782200,1359300,2141500,52407.0,,139796
R0006194,2024,491600,625700,1117300,32937.0,,71174
R0006195,2024,218000,929400,1147400,14606.0,,73191
R0006199,2024,996700,845400,1842100,66779.0,,119736
R0006207,2024,335500,1334400,1669900,22479.0,,108198
R0006214,2024,2866900,2335200,5202100,192082.0,,344856
R0006222,2024,543200,1187900,1731100,36394.0,,112299
R0006227,2024,2012600,1091800,3104400,134844.0,,204310
R0006228,2024,1212000,1070100,2282100,81204.0,,149216
R0006229,2024,365100,804400,1169500,24462.0,,74672
R0006232,2024,611400,954000,1565400,40964.0,,101197
R0006233,2024,1028600,1074600,2103200,68916.0,,137229
R0006234,2024,423600,1816800,2240400,28381.0,,146422
R0006235,2024,267800,623800,891600,17943.0,,56052
R0006276,2024,1264700,902200,2166900,84735.0,,141497
R0006278,2024,344200,679700,1023900,23061.0,,64916
R0006280,2024,584100,999900,1584000,39135.0,,102443
R0006281,2024,203100,732100,935200,13608.0,,58973
R0006282,2024,639000,574000,1213000,42813.0,,77586
R0006289,2024,490000,902800,1392800,32830.0,,89633
R0006294,2024,276600,685000,961600,18532.0,,60742
R0006296,2024,251280,2261520,2512800,16836.0,,164673
R0006297,2024,6628700,3264700,9893400,444123.0,,659173
R0006298,2024,126470,1138230,1264700,8473.0,,81050
R0006299,2024,2082800,1762600,3845400,139548.0,,253957
R0006301,2024,873500,957100,1830600,58525.0,,118965
R0006303,2024,874600,775200,1649800,58598.0,,106852
R0006305,2024,445200,830700,1275900,29828.0,,81800
R0006311,2024,1120200,1884600,3004800,75053.0,,197637
R0006318,2024,932100,1261600,2193700,62451.0,,143293
R0006320,2024,943245,838300,1781545,63197.0,,115679
R0006325,2024,343930,3095370,3439300,23043.0,,226748
R0006327,2024,746000,1457100,2203100,49982.0,,143923
R0006329,2024,996900,839700,1836600,66792.0,,119367
R0006330,2024,1720300,1715200,3435500,115260.0,,226494
R0006334,2024,179810,1618290,1798100,12047.0,,116788
R0006339,2024,260700,1041300,1302000,13782.0,,83549
R0006343,2024,330200,1038800,1369000,22123.0,,88038
R0006344,2024,1877600,1236400,3114000,125799.0,,204953
R0006345,2024,480400,1207000,1687400,32187.0,,109371
R0006346,2024,161600,1188500,1350100,10827.0,,86772
R0006347,2024,198300,1378300,1576600,13286.0,,101947
R0006348,2024,1325300,1455900,2781200,88795.0,,182655
R0006351,2024,1012700,824100,1836800,67851.0,,119381
R0006353,2024,252100,910900,1163000,16891.0,,74236
R0006354,2024,984500,846700,1831200,65962.0,,119005
R0006358,2024,1207000,1054200,2261200,80869.0,,147815
R0006359,2024,1147800,1070700,2218500,76903.0,,144955
R0006366,2024,155200,939100,1094300,10398.0,,69633
R0006377,2024,354200,947100,1301300,23731.0,,83502
R0006379,2024,171130,1540170,1711300,11466.0,,110972
R0006380,2024,862400,1774200,2636600,57781.0,,172967
R0006383,2024,149800,1348200,1498000,10037.0,,96681
R0006395,2024,791500,964900,1756400,53031.0,,113994
R0006397,2024,414600,833000,1247600,27778.0,,79904
R0006398,2024,417300,1071800,1489100,27959.0,,96085
R0006400,2024,551900,1000300,1552200,36977.0,,100312
R0006403,2024,192700,938100,1130800,12911.0,,72079
R0006404,2024,158800,885800,1044600,10640.0,,66303
R0006406,2024,1505300,2063300,3568600,100855.0,,235411
R0006410,2024,459600,1337500,1797100,30793.0,,116721
R0006413,2024,515600,1738700,2254300,34545.0,,147353
R0006414,2024,664500,994700,1659200,44522.0,,107481
R0006415,2024,444100,1378900,1823000,26070.0,,118456
R0006416,2024,117460,1057140,1174600,7870.0,,75013
R0006417,2024,945110,904100,1849210,63322.0,,120212
R0006418,2024,548500,760700,1309200,36750.0,,84031
R0006424,2024,394700,1360400,1755100,26445.0,,113907
R0006425,2024,208200,804900,1013100,13949.0,,64193
R0006426,2024,488900,822900,1311800,32756.0,,84206
R0006430,2024,402700,1600900,2003600,26981.0,,130556
R0006439,2024,199930,1799370,1999300,13395.0,,130268
R0006442,2024,1406200,1025300,2431500,94215.0,,159226
R0006445,2024,1966300,1656100,3622400,131742.0,,239016
R0006446,2024,432600,842300,1274900,28984.0,,81733
R0006451,2024,523344,1382400,1905744,35064.0,,124000
R0006452,2024,815100,795400,1610500,54612.0,,104219
R0006456,2024,144100,1026600,1170700,9655.0,,74752
R0006457,2024,544200,773600,1317800,36461.0,,84608
R0006460,2024,89400,782600,872000,5990.0,,54739
R0006461,2024,487100,562200,1049300,32636.0,,66618
R0006463,2024,1260200,993900,2254100,84433.0,,147340
R0006464,2024,158080,1422720,1580800,10591.0,,102229
R0006469,2024,503300,913600,1416900,33721.0,,91247
R0006471,2024,538400,1246300,1784700,36073.0,,115890
R0006476,2024,314400,1154600,1469000,21065.0,,94738
R0006478,2024,238100,865500,1103600,15953.0,,70256
R0006479,2024,130550,1174950,1305500,8747.0,,83784
R0006487,2024,221300,686300,907600,14827.0,,57124
R0006490,2024,283300,766000,1049300,18981.0,,66618
R0006492,2024,2640300,1052000,3692300,176900.0,,243699
R0006493,2024,1454400,1267100,2721500,97445.0,,178656
R0006494,2024,863900,2018700,2882600,57881.0,,189449
R0006496,2024,1385400,1455400,2840800,92822.0,,186649
R0006499,2024,225900,2033100,2259000,15135.0,,147668
R0006500,2024,2512900,4123100,6636000,168364.0,,440927
R0006502,2024,1103400,937400,2040800,73928.0,,133049
R0006505,2024,1763200,848400,2611600,118134.0,,171292
R0006510,2024,738300,1106700,1845000,45781.0,,119930
R0006515,2024,184180,1657620,1841800,12340.0,,119716
R0006517,2024,481600,1172200,1653800,32267.0,,107120
R0006521,2024,793800,1001200,1795000,53185.0,,116580
R0006523,2024,355100,1752400,2107500,23792.0,,137518
R0006524,2024,2782400,2177300,4959700,186421.0,,328615
R0006525,2024,1011079,1438700,2449779,67743.0,,160450
R0006531,2024,777400,1002600,1780000,52086.0,,115575
R0006536,2024,228300,877000,1105300,15296.0,,70370
R0006544,2024,488300,742500,1230800,32716.0,,78779
R0006551,2024,954900,836300,1791200,63978.0,,116325
R0006553,2024,191400,1249800,1441200,12824.0,,92875
R0006554,2024,224100,988400,1212500,15015.0,,77553
R0006559,2024,1298300,901500,2199800,86986.0,,143702
R0006562,2024,4575900,6268500,10844400,306585.0,,722890
R0006564,2024,227300,558800,786100,15229.0,,48984
R0006566,2024,914400,2529200,3443600,61265.0,,227036
R0006567,2024,591600,1035100,1626700,39637.0,,105304
R0006568,2024,657000,840400,1497400,44019.0,,96641
R0006569,2024,496000,1037100,1533100,33232.0,,99033
R0006570,2024,1223500,1663300,2886800,81975.0,,189731
R0006573,2024,419000,875800,1294800,28073.0,,83067
R0006576,2024,1077300,1059400,2136700,72179.0,,139474
R0006581,2024,851800,1372400,2224200,53385.0,,145336
R0006582,2024,1050100,745200,1795300,70357.0,,116600
R0006593,2024,1614300,1049800,2664100,108158.0,,174810
R0006595,2024,770100,1047400,1817500,51597.0,,118088
R0006601,2024,658200,845000,1503200,44099.0,,97029
R0006602,2024,508100,651100,1159200,34043.0,,73981
R0006609,2024,2268200,2493600,4761800,151969.0,,315356
R0006610,2024,2279400,2540800,4820200,152720.0,,319268
R0006611,2024,1705500,2269300,3974800,114269.0,,262627
R0006612,2024,3828000,2120700,5948700,256476.0,,394878
R0006613,2024,355800,796800,1152600,23839.0,,73539
R0006615,2024,408000,878200,1286200,27336.0,,82490
R0006619,2024,1145100,879700,2024800,76722.0,,131977
R0006621,2024,1341900,925000,2266900,89907.0,,148197
R0006623,2024,1320400,2099300,3419700,88467.0,,225435
R0006631,2024,740100,664100,1404200,49587.0,,90396
R0006650,2024,3788500,1568700,5357200,253830.0,,355247
R0006651,2024,1924800,1920600,3845400,128961.0,,253957
R0006655,2024,99960,899640,999600,6697.0,,63288
R0006656,2024,649800,947000,1596800,43537.0,,103301
R0006658,2024,824300,863100,1687400,55228.0,,109371
R0006660,2024,681100,591800,1272900,45634.0,,81599
R0006664,2024,1264000,1858000,3122000,84688.0,,205489
R0006668,2024,379200,970300,1349500,25406.0,,86732
R0006673,2024,709300,838100,1547400,47523.0,,99991
R0006674,2024,300500,862900,1163400,20134.0,,74263
R0006678,2024,933800,844800,1778600,62565.0,,115481
R0006691,2024,3556100,1650500,5206600,238259.0,,345157
R0006692,2024,704400,1057100,1761500,47195.0,,114336
R0006695,2024,774700,699100,1473800,51905.0,,95060
R0006696,2024,802300,1209100,2011400,53754.0,,131079
R0006699,2024,1249300,1359500,2608800,83703.0,,171105
R0006700,2024,912900,1132800,2045700,61164.0,,133377
R0006703,2024,240800,712200,953000,16134.0,,60166
R0006704,2024,382000,573000,955000,21909.0,,60300
R0006710,2024,1021500,810200,1831700,68441.0,,119039
R0006715,2024,270100,972900,1243000,18097.0,,79596
R0006717,2024,2161200,2349700,4510900,144800.0,,298545
R0006721,2024,126090,1134810,1260900,8448.0,,80795
R0006731,2024,896400,865300,1761700,60059.0,,114349
R0006732,2024,137830,1240470,1378300,9235.0,,88661
R0006734,2024,527500,1013800,1541300,35343.0,,99582
R0006735,2024,128020,1152180,1280200,8577.0,,82088
R0006740,2024,836900,1054200,1891100,56072.0,,123019
R0006744,2024,246000,855800,1101800,16482.0,,70136
R0006745,2024,544000,845900,1389900,36448.0,,89438
R0006746,2024,1637800,557400,2195200,109733.0,,143393
R0006748,2024,868000,853400,1721400,58156.0,,111649
R0006752,2024,1568300,1088800,2657100,105076.0,,174341
R0006753,2024,1455700,1728700,3184400,97532.0,,209670
R0006755,2024,365500,806900,1172400,24489.0,,74866
R0006756,2024,970900,881300,1852200,65050.0,,120412
R0006758,2024,394600,679000,1073600,26438.0,,68246
R0006759,2024,627600,779500,1407100,42049.0,,90591
R0006762,2024,2223400,1062800,3286200,148968.0,,216490
R0006763,2024,485400,879900,1365300,32522.0,,87790
R0006767,2024,173990,1565910,1739900,11657.0,,112888
R0006769,2024,303800,545700,849500,20355.0,,53232
R0006771,2024,152900,918000,1070900,10244.0,,68065
R0006772,2024,751000,1184000,1935000,50317.0,,125960
R0006778,2024,570800,1275400,1846200,38244.0,,120010
R0006783,2024,2368300,1674900,4043200,158676.0,,267209
R0006784,2024,600000,1047500,1647500,40200.0,,106698
R0006792,2024,122820,1105380,1228200,8229.0,,78604
R0006793,2024,198000,1649725,1847725,13266.0,,120113
R0006799,2024,600600,1604600,2205200,40240.0,,144063
R0006800,2024,104320,938880,1043200,6989.0,,66209
R0006806,2024,4108700,2182800,6291500,275283.0,,417846
R0006807,2024,769200,1059900,1829100,51536.0,,118865
R0006808,2024,729000,1532700,2261700,48843.0,,147849
R0006810,2024,616900,869900,1486800,41332.0,,95931
R0006814,2024,654700,1445300,2100000,43865.0,,137015
R0006815,2024,516500,908800,1425300,34606.0,,91810
R0006823,2024,2030600,1550200,3580800,136050.0,,236229
R0006825,2024,3272400,1611200,4883600,219251.0,,323516
R0006827,2024,336100,1363900,1700000,22519.0,,110215
R0006828,2024,1187800,1171400,2359200,79582.0,,154381
R0006830,2024,624900,1031300,1656200,41868.0,,107280
R0006833,2024,408900,1357900,1766800,27396.0,,114691
R0006838,2024,245600,1488000,1733600,16456.0,,112466
R0006850,2024,122490,1102410,1224900,8207.0,,78383
R0006852,2024,905100,915800,1820900,60642.0,,118315
R0006853,2024,1494600,1638000,3132600,100138.0,,206199
R0006858,2024,276900,557500,834400,18552.0,,52220
R0006859,2024,616500,922700,1539200,41306.0,,99441
R0006863,2024,1234300,1774900,3009200,82698.0,,197931
R0006864,2024,532100,1266900,1799000,35651.0,,116848
R0006865,2024,1218900,1683000,2901900,81666.0,,190742
R0006869,2024,1403900,1643100,3047000,94061.0,,200464
R0006871,2024,683000,933600,1616600,45761.0,,104627
R0006873,2024,1722200,1030100,2752300,115387.0,,180719
R0006876,2024,223800,1353500,1577300,14995.0,,101994
R0006877,2024,752900,830500,1583400,50444.0,,102403
R0006878,2024,664000,842500,1506500,44488.0,,97251
R0006879,2024,122310,1100790,1223100,8195.0,,78263
R0006884,2024,662500,846800,1509300,44388.0,,97438
R0006887,2024,1450400,1195300,2645700,97177.0,,173577
R0006891,2024,1107200,1855300,2962500,74182.0,,194803
R0006896,2024,313300,1380200,1693500,20991.0,,109780
R0006897,2024,191790,1726110,1917900,12850.0,,124814
R0006898,2024,72066,1101600,1173666,4828.0,,74951
R0006899,2024,501100,991900,1493000,33574.0,,96346
R0006903,2024,1325000,1572700,2897700,88775.0,,190461
R0006907,2024,2158800,1028500,3187300,144640.0,,209864
R0006909,2024,1037700,1163900,2201600,69526.0,,143822
R0006911,2024,514100,771100,1285200,30759.0,,82423
R0006913,2024,1154300,1010900,2165200,77338.0,,141383
R0006920,2024,1302761,1876100,3178861,87285.0,,209299
R0006924,2024,909300,1018000,1927300,60923.0,,125444
R0006929,2024,490000,735100,1225100,29145.0,,78397
R0006933,2024,375600,1184900,1560500,25165.0,,100869
R0006936,2024,219400,778500,997900,14700.0,,63174
R0006937,2024,1319600,1071200,2390800,88413.0,,156499
R0006941,2024,802700,642800,1445500,53781.0,,93164
R0006942,2024,945600,955900,1901500,63355.0,,123716
R0006943,2024,607300,1394700,2002000,40689.0,,130449
R0006945,2024,846100,895700,1741800,56689.0,,113016
R0006947,2024,2139000,1933000,4072000,143313.0,,269139
R0006948,2024,3651200,1966100,5617300,244630.0,,372674
R0006949,2024,149680,1347120,1496800,10029.0,,96601
R0006950,2024,1141200,1415300,2556500,76460.0,,167601
R0006951,2024,1070300,843800,1914100,71710.0,,124560
R0006952,2024,613200,801700,1414900,41084.0,,91113
R0006956,2024,522300,2268300,2790600,34994.0,,183285
R0006960,2024,441700,752600,1194300,29594.0,,76333
R0006961,2024,120430,1083870,1204300,8069.0,,77003
R0006964,2024,4240500,1731800,5972300,284114.0,,396459
R0006967,2024,815700,1220100,2035800,54652.0,,132714
R0006969,2024,705400,910600,1616000,47262.0,,104587
R0006971,2024,621700,834700,1456400,41654.0,,93894
R0006982,2024,463000,1148300,1611300,31021.0,,104272
R0006988,2024,819700,1069200,1888900,54920.0,,122871
R0006990,2024,541200,1060300,1601500,32576.0,,103616
R0006995,2024,84300,850700,935000,1963.0,,58960
R0006997,2024,540100,734100,1274200,36187.0,,81686
R0006998,2024,570800,1053000,1623800,38244.0,,105110
R0007001,2024,510000,812500,1322500,34170.0,,84923
R0007002,2024,719000,1273900,1992900,48173.0,,129839
R0007005,2024,821600,864100,1685700,55047.0,,109257
R0007006,2024,604000,637300,1241300,40468.0,,79482
R0007007,2024,918100,796100,1714200,61513.0,,111166
R0007011,2024,999600,1978800,2978400,66973.0,,195868
R0007012,2024,182910,1646190,1829100,12255.0,,118865
R0007014,2024,1014500,1016400,2030900,67972.0,,132385
R0007020,2024,603600,982800,1586400,40441.0,,102604
R0007034,2024,1053400,847200,1900600,70578.0,,123655
R0007035,2024,3294500,1880700,5175200,220732.0,,343053
R0007037,2024,1284400,1144500,2428900,86055.0,,159051
R0007038,2024,246400,903600,1150000,16509.0,,73365
R0007043,2024,829300,789800,1619100,55563.0,,104795
R0007052,2024,142600,913400,1056000,9554.0,,67067
R0007059,2024,542800,1784300,2327100,36368.0,,152231
R0007074,2024,800100,1731700,2531800,53607.0,,165946
R0007076,2024,882300,2007800,2890100,59114.0,,189952
R0007077,2024,137310,1235790,1373100,9200.0,,88313
R0007079,2024,1346200,1330000,2676200,90195.0,,175620
R0007081,2024,349500,1112400,1461900,23417.0,,94262
R0007083,2024,941700,838300,1780000,63094.0,,115575
R0007087,2024,712800,682500,1395300,47758.0,,89800
R0007096,2024,88110,792990,881100,5903.0,,55349
R0007097,2024,523700,567100,1090800,35088.0,,69399
R0007098,2024,379600,1263400,1643000,25433.0,,106396
R0007101,2024,1183100,1090700,2273800,79268.0,,148660
R0007105,2024,728500,2758000,3486500,48810.0,,229911
R0007109,2024,2929100,2269500,5198600,196250.0,,344621
R0007112,2024,248400,1173200,1421600,16643.0,,91562
R0007113,2024,340200,725800,1066000,22793.0,,67737
R0007114,2024,270810,2437290,2708100,18144.0,,177758
R0007121,2024,513000,877500,1390500,34371.0,,89479
R0007124,2024,376400,1065000,1441400,25219.0,,92889
R0007129,2024,741500,864100,1605600,49681.0,,103890
R0007133,2024,579100,846300,1425400,38800.0,,91817
R0007134,2024,1385700,922900,2308600,92842.0,,150991
R0007137,2024,1161100,707200,1868300,77794.0,,121491
R0007138,2024,1329500,2419000,3748500,85392.0,,247465
R0007145,2024,349000,1601700,1950700,23383.0,,127012
R0007148,2024,148131,745600,893731,9925.0,,56195
R0007152,2024,453700,810500,1264200,30398.0,,81016
R0007156,2024,1277200,1925300,3202500,85572.0,,210883
R0007158,2024,462800,1242300,1705100,31008.0,,110557
R0007162,2024,93740,843660,937400,6280.0,,59121
R0007178,2024,158630,1427670,1586300,10628.0,,102597
R0007180,2024,867500,836100,1703600,58123.0,,110456
R0007182,2024,1246000,1294700,2540700,83482.0,,166542
R0007183,2024,451200,915800,1367000,30230.0,,87904
R0007195,2024,1669800,2352200,4022000,111877.0,,265789
R0007197,2024,1985400,1094600,3080000,133022.0,,202675
R0007198,2024,546000,1821800,2367800,36582.0,,154958
R0007203,2024,145840,1312560,1458400,9771.0,,94028
R0007204,2024,517100,1360900,1878000,34646.0,,122141
R0007212,2024,251900,1032100,1284000,16877.0,,82343
R0007213,2024,467000,1791400,2258400,31289.0,,147628
R0007217,2024,820600,868400,1689000,54980.0,,109478
R0007218,2024,1612300,2021100,3633400,108024.0,,239753
R0007219,2024,186000,957300,1143300,12462.0,,72916
R0007220,2024,1128200,949600,2077800,75589.0,,135528
R0007223,2024,763900,1938900,2702800,51181.0,,177403
R0007224,2024,1018100,1637500,2655600,68213.0,,174240
R0007226,2024,760400,568400,1328800,50947.0,,85345
R0007227,2024,2077000,1362900,3439900,139159.0,,226788
R0007228,2024,598400,1252500,1850900,40093.0,,120325
R0007230,2024,842300,846300,1688600,56434.0,,109451
R0007231,2024,1848700,3129600,4978300,123863.0,,329861
R0007233,2024,112900,980100,1093000,3879.0,,69546
R0007237,2024,572100,1026500,1598600,38331.0,,103421
R0007239,2024,1146000,918800,2064800,76782.0,,134657
R0007241,2024,2392500,1589800,3982300,160298.0,,263129
R0007243,2024,1713400,1573600,3287000,114798.0,,216544
R0007244,2024,91000,819000,910000,6097.0,,57285
R0007245,2024,378500,1048500,1427000,21674.0,,91924
R0007246,2024,507400,1018900,1526300,30311.0,,98577
R0007251,2024,1010400,1017100,2027500,67697.0,,132158
R0007252,2024,750000,1274100,2024100,50251.0,,131930
R0007253,2024,481100,896900,1378000,32234.0,,88641
R0007254,2024,933000,1033300,1966300,62511.0,,128057
R0007258,2024,609600,1054100,1663700,40843.0,,107783
R0007260,2024,935800,1201700,2137500,62699.0,,139528
R0007263,2024,197570,1778130,1975700,13237.0,,128687
R0007269,2024,137960,1241640,1379600,9243.0,,88748
R0007271,2024,646400,1354400,2000800,43309.0,,130369
R0007274,2024,264200,955600,1219800,17701.0,,78042
R0007276,2024,647200,900500,1547700,43362.0,,100011
R0007277,2024,91660,824940,916600,6141.0,,57727
R0007278,2024,558400,1665000,2223400,37413.0,,145283
R0007284,2024,643600,831100,1474700,43121.0,,95120
R0007286,2024,2975300,1130400,4105700,199345.0,,271397
R0007287,2024,612100,1344400,1956500,41011.0,,127401
R0007290,2024,480000,720000,1200000,32160.0,,76715
R0007297,2024,275800,703500,979300,18479.0,,61928
R0007299,2024,187900,1186800,1374700,12589.0,,88420
R0007300,2024,325700,1692900,2018600,21822.0,,131561
R0007305,2024,493200,877500,1370700,33044.0,,88152
R0007308,2024,2065900,1787500,3853400,138415.0,,254493
R0007311,2024,1268000,1986200,3254200,84956.0,,214346
R0007318,2024,233400,931000,1164400,15638.0,,74330
R0007319,2024,683100,957900,1641000,45768.0,,106262
R0007321,2024,1491400,1450900,2942300,99924.0,,193449
R0007326,2024,345500,949000,1294500,23149.0,,83047
R0007328,2024,1201600,904800,2106400,80507.0,,137444
R0007331,2024,370700,843100,1213800,24837.0,,77640
R0007333,2024,335400,713900,1049300,22472.0,,66618
R0007345,2024,1122800,656200,1779000,75228.0,,115508
R0007350,2024,1385700,1554900,2940600,92842.0,,193335
R0007357,2024,399700,816300,1216000,26780.0,,77787
R0007358,2024,710400,752900,1463300,47597.0,,94356
R0007363,2024,857267,1036900,1894167,57437.0,,123224
R0007366,2024,342000,1879300,2221300,22914.0,,145142
R0007372,2024,674100,880000,1554100,45165.0,,100440
R0007375,2024,319900,849800,1169700,21433.0,,74685
R0007381,2024,1337400,1980200,3317600,89606.0,,218594
R0007386,2024,291600,772300,1063900,19537.0,,67596
R0007389,2024,375600,813100,1188700,25165.0,,75958
R0007390,2024,490800,1019700,1510500,32884.0,,97519
R0007392,2024,611500,1110900,1722400,40971.0,,111716
R0007395,2024,1772900,2065000,3837900,118784.0,,253454
R0007396,2024,884700,1433900,2318600,59275.0,,151661
R0007399,2024,3166900,1387000,4553900,212182.0,,301426
R0007400,2024,847100,1017200,1864300,56755.0,,121223
R0007404,2024,3452600,3324600,6777200,231324.0,,450387
R0007405,2024,219300,1107800,1327100,14693.0,,85231
R0007414,2024,780474,844100,1624574,52292.0,,105161
R0007415,2024,982500,789300,1771800,65828.0,,115026
R0007416,2024,1747800,851000,2598800,117103.0,,170435
R0007420,2024,769100,838900,1608000,51530.0,,104051
R0007421,2024,1984600,1842800,3827400,132968.0,,252751
R0007424,2024,676900,789200,1466100,45352.0,,94544
R0007427,2024,3512000,1445100,4957100,235304.0,,328441
R0007430,2024,522400,623300,1145700,35001.0,,73077
R0007434,2024,357600,721900,1079500,23959.0,,68642
R0007440,2024,280300,1199800,1480100,18780.0,,95482
R0007441,2024,550500,1056100,1606600,36883.0,,103957
R0007445,2024,723400,844000,1567400,48468.0,,101331
R0007446,2024,503200,833000,1336200,33714.0,,85840
R0007448,2024,975500,1356300,2331800,65359.0,,152546
R0007449,2024,389500,523000,912500,26097.0,,57453
R0007450,2024,1441700,845300,2287000,96594.0,,149544
R0007454,2024,1077900,1159800,2237700,72219.0,,146241
R0007455,2024,2005800,2044200,4050000,134389.0,,267665
R0007456,2024,255200,730100,985300,17098.0,,62330
R0007461,2024,1031900,954600,1986500,69137.0,,129411
R0007462,2024,465800,853900,1319700,31209.0,,84735
R0007464,2024,434620,3911580,4346200,29120.0,,287510
R0007465,2024,584800,752500,1337300,39182.0,,85914
R0007466,2024,602900,1251300,1854200,40394.0,,120546
R0007467,2024,1657700,989300,2647000,111066.0,,173664
R0007468,2024,1823900,1017000,2840900,122201.0,,186655
R0007469,2024,1334800,857500,2192300,89432.0,,143199
R0007470,2024,2203900,1018100,3222000,147661.0,,212189
R0007471,2024,2866000,1601500,4467500,192022.0,,295638
R0007472,2024,394300,926300,1320600,26418.0,,84795
R0007475,2024,2108400,1551600,3660000,141263.0,,241535
R0007481,2024,1910300,1429900,3340200,127990.0,,220108
R0007486,2024,3863300,1682800,5546100,258841.0,,367904
R0007489,2024,328400,1066700,1395100,22003.0,,89787
R0007491,2024,265100,568000,833100,17762.0,,52133
R0007493,2024,1289800,1833900,3123700,86417.0,,205603
R0007494,2024,350500,525700,876200,19798.0,,55020
R0007496,2024,1940800,1017500,2958300,130034.0,,194521
R0007505,2024,931900,873600,1805500,62437.0,,117284
R0007506,2024,672800,1048200,1721000,45078.0,,111622
R0007511,2024,532200,1415200,1947400,35658.0,,126791
R0007513,2024,1694600,909000,2603600,113538.0,,170756
R0007515,2024,1063600,937900,2001500,71261.0,,130416
R0007522,2024,433100,860400,1293500,29018.0,,82980
R0007523,2024,510400,663400,1173800,34197.0,,74960
R0007525,2024,740800,1072500,1813300,49633.0,,117806
R0007529,2024,875100,842900,1718000,58632.0,,111421
R0007530,2024,890500,1248000,2138500,59664.0,,139595
R0007531,2024,928700,947300,1876000,62223.0,,122007
R0007532,2024,450900,696000,1146900,30210.0,,73157
R0007533,2024,1130000,857900,1987900,75710.0,,129504
R0007535,2024,835400,716900,1552300,55972.0,,100319
R0007536,2024,499900,693300,1193200,33493.0,,76259
R0007537,2024,748800,799400,1548200,50170.0,,100044
R0007538,2024,149300,1343700,1493000,10003.0,,96346
R0007543,2024,714800,806400,1521200,47891.0,,98235
R0007552,2024,306900,913400,1220300,20562.0,,78075
R0007555,2024,246400,750300,996700,16509.0,,63094
R0007559,2024,154100,1386900,1541000,10325.0,,99562
R0007561,2024,1159000,977700,2136700,77653.0,,139474
R0007562,2024,1250900,847100,2098000,80125.0,,136881
R0007564,2024,599800,719800,1319600,40187.0,,84728
R0007566,2024,823500,1016200,1839700,55175.0,,119575
R0007568,2024,90480,814320,904800,6062.0,,56937
R0007569,2024,404000,842800,1246800,27068.0,,79851
R0007570,2024,1304300,963500,2267800,87388.0,,148258
R0007572,2024,3216200,2218100,5434300,215485.0,,360413
R0007573,2024,1050800,1014300,2065100,70404.0,,134677
R0007574,2024,141400,937900,1079300,9474.0,,68628
R0007578,2024,218500,1966500,2185000,14640.0,,142710
R0007579,2024,128090,1152810,1280900,8582.0,,82135
R0007581,2024,1447200,873500,2320700,96962.0,,151802
R0007582,2024,387600,2450800,2838400,25969.0,,186488
R0007585,2024,611100,842200,1453300,40944.0,,93686
R0007586,2024,300000,644100,944100,20100.0,,59570
R0007587,2024,1916900,1603200,3520100,128432.0,,232162
R0007592,2024,1259100,850000,2109100,80675.0,,137625
R0007593,2024,101050,909450,1010500,6770.0,,64019
R0007595,2024,1597800,2271400,3869200,107053.0,,255551
R0007602,2024,136900,1232100,1369000,9172.0,,88038
R0007604,2024,947800,1390300,2338100,63503.0,,152968
R0007613,2024,1497900,1072500,2570400,100359.0,,168532
R0007616,2024,2416000,1731200,4147200,161872.0,,274177
R0007621,2024,1132700,951800,2084500,75891.0,,135977
R0007629,2024,138840,1249560,1388400,9302.0,,89338
R0007631,2024,334900,1669000,2003900,22438.0,,130576
R0007633,2024,1547200,1523800,3071000,103662.0,,202072
R0007637,2024,164540,1480860,1645400,11024.0,,106557
R0007639,2024,479100,854700,1333800,32100.0,,85680
R0007641,2024,593600,1354900,1948500,39771.0,,126865
R0007649,2024,575500,1158600,1734100,38559.0,,112500
R0007651,2024,121540,1093860,1215400,8143.0,,77747
R0007653,2024,301900,957400,1259300,16542.0,,80688
R0007656,2024,692700,1018800,1711500,46411.0,,110986
R0007658,2024,617000,749400,1366400,41339.0,,87864
R0007661,2024,448800,1723200,2172000,30070.0,,141839
R0007667,2024,558300,1350000,1908300,37406.0,,124171
R0007669,2024,349000,813200,1162200,23383.0,,74182
R0007672,2024,416000,654600,1070600,27872.0,,68045
R0007677,2024,793900,1138300,1932200,53191.0,,125772
R0007679,2024,132560,1193040,1325600,8882.0,,85130
R0007681,2024,2164301,3387900,5552201,145008.0,,368312
R0007682,2024,497700,838000,1335700,33346.0,,85807
R0007687,2024,154500,1099100,1253600,10352.0,,80306
R0007689,2024,499000,1054700,1553700,33433.0,,100413
R0007691,2024,1121900,1807500,2929400,75167.0,,192585
R0007696,2024,2910800,1012400,3923200,195024.0,,259169
R0007699,2024,151180,1360620,1511800,10129.0,,97606
R0007700,2024,465800,1274400,1740200,27523.0,,112908
R0007702,2024,730900,846300,1577200,48970.0,,101987
R0007703,2024,205392,500000,705392,13761.0,,43576
R0007706,2024,1285400,2053100,3338500,86122.0,,219995
R0007708,2024,368200,732500,1100700,24669.0,,70062
R0007717,2024,627900,1010000,1637900,42069.0,,106054
R0007730,2024,360100,1271600,1631700,24127.0,,105639
R0007734,2024,3840404,1797000,5637404,257307.0,,374021
R0007735,2024,1420500,1130500,2551000,95174.0,,167232
R0007736,2024,471000,314000,785000,31557.0,,48910
R0007737,2024,580200,682800,1263000,38873.0,,80936
R0007740,2024,1281400,974400,2255800,85854.0,,147454
R0007742,2024,859500,994000,1853500,57587.0,,120500
R0007744,2024,1939200,1728700,3667900,129926.0,,242064
R0007748,2024,2745200,1026100,3771300,183928.0,,248992
R0007749,2024,978900,1018600,1997500,65586.0,,130148
R0007762,2024,841200,852700,1693900,56360.0,,109806
R0007768,2024,752200,1557900,2310100,50397.0,,151092
R0007769,2024,486200,784400,1270600,32575.0,,81445
R0007773,2024,187370,1686330,1873700,12554.0,,121853
R0007774,2024,981300,1019400,2000700,65747.0,,130362
R0007781,2024,445200,622800,1068000,29828.0,,67871
R0007782,2024,752800,951000,1703800,50438.0,,110470
R0007785,2024,131980,1187820,1319800,8843.0,,84742
R0007787,2024,516600,1065500,1582100,34612.0,,102316
R0007791,2024,270600,1048600,1319200,18130.0,,84701
R0007792,2024,1593200,1760100,3353300,106744.0,,220986
R0007794,2024,1336700,1661500,2998200,89559.0,,197194
R0007800,2024,826700,848600,1675300,55389.0,,108560
R0007801,2024,1143900,1083700,2227600,76641.0,,145564
R0007802,2024,582600,834600,1417200,39034.0,,91267
R0007804,2024,567500,1329300,1896800,38023.0,,123401
R0007808,2024,858600,859400,1718000,57526.0,,111421
R0007809,2024,1146100,953900,2100000,76789.0,,137015
R0007814,2024,491800,1009200,1501000,32951.0,,96882
R0007822,2024,838700,1328800,2167500,56193.0,,141538
R0007828,2024,976500,903600,1880100,65426.0,,122282
R0007829,2024,630700,770100,1400800,42257.0,,90169
R0007834,2024,510500,765700,1276200,34204.0,,81820
R0007840,2024,867100,1808600,2675700,58096.0,,175587
R0007841,2024,185060,1665540,1850600,12399.0,,120305
R0007842,2024,891200,869800,1761000,59710.0,,114302
R0007843,2024,495900,1383100,1879000,33225.0,,122208
R0007844,2024,159680,1437120,1596800,10699.0,,103301
R0007855,2024,1426100,1165000,2591100,95549.0,,169919
R0007857,2024,734200,775800,1510000,49191.0,,97485
R0007860,2024,1491700,1354800,2846500,99944.0,,187031
R0007863,2024,771300,934000,1705300,47992.0,,110570
R0007866,2024,347500,929300,1276800,23283.0,,81861
R0007869,2024,2011800,2697300,4709100,134791.0,,311825
R0007870,2024,5230200,1913400,7143600,350424.0,,474936
R0007873,2024,833300,1147900,1981200,55831.0,,129055
R0007882,2024,2300900,815900,3116800,154160.0,,205141
R0007886,2024,284670,2562030,2846700,19073.0,,187044
R0007890,2024,509800,947200,1457000,34157.0,,93934
R0007895,2024,878100,773500,1651600,58833.0,,106972
R0007897,2024,1692500,1079900,2772400,113398.0,,182066
R0007898,2024,123160,1108440,1231600,8252.0,,78832
R0007902,2024,334000,825600,1159600,22378.0,,74008
R0007907,2024,641300,1416600,2057900,42967.0,,134194
R0007914,2024,111800,742100,853900,7491.0,,53526
R0007924,2024,561800,885200,1447000,37641.0,,93264
R0007926,2024,1784400,853900,2638300,119555.0,,173081
R0007931,2024,562600,637900,1200500,37694.0,,76749
R0007933,2024,1380300,1142500,2522800,92480.0,,165343
R0007934,2024,2023600,827600,2851200,135581.0,,187345
R0007936,2024,896600,1018800,1915400,60072.0,,124647
R0007937,2024,2023100,2176900,4200000,131863.0,,277715
R0007938,2024,423500,1372300,1795800,28375.0,,116634
R0007939,2024,1187000,1679000,2866000,79529.0,,188337
R0007945,2024,586600,1005200,1591800,35618.0,,102966
R0007953,2024,734200,1039800,1774000,49191.0,,115173
R0007954,2024,76470,688230,764700,5123.0,,47550
R0007955,2024,1079400,1066400,2145800,72320.0,,140084
R0007956,2024,1376900,833100,2210000,92252.0,,144385
R0007958,2024,721600,1885800,2607400,48347.0,,171011
R0007963,2024,430100,645200,1075300,25132.0,,68360
R0007965,2024,517500,823500,1341000,34673.0,,86162
R0007975,2024,1442800,1024400,2467200,96668.0,,161617
R0007979,2024,288700,704400,993100,19343.0,,62853
R0007989,2024,1174300,1986300,3160600,78678.0,,208075
R0007990,2024,652600,1165100,1817700,43724.0,,118101
R0007998,2024,1087600,827100,1914700,72869.0,,124600
R0008008,2024,783400,1727200,2510600,52488.0,,164525
R0008011,2024,780200,697200,1477400,52273.0,,95301
R0008012,2024,3472500,1338000,4810500,232658.0,,318619
R0008013,2024,701500,1730400,2431900,47001.0,,159252
R0008016,2024,110750,996750,1107500,7420.0,,70518
R0008022,2024,88830,799470,888300,5952.0,,55831
R0008024,2024,755600,1150200,1905800,50625.0,,124004
R0008030,2024,428000,642000,1070000,24991.0,,68005
R0008032,2024,2387500,2317900,4705400,159963.0,,311577
R0008033,2024,1280900,888000,2168900,85820.0,,141631
R0008034,2024,823800,832400,1656200,55195.0,,107280
R0008039,2024,561800,823300,1385100,37641.0,,89117
R0008041,2024,875400,919200,1794600,58652.0,,116553
R0008042,2024,395300,1463700,1859000,26485.0,,120868
R0008056,2024,638400,930300,1568700,42773.0,,101418
R0008058,2024,1434225,1151400,2585625,96093.0,,169552
R0008059,2024,664500,709400,1373900,44522.0,,88366
R0008061,2024,2796700,2233100,5029800,187379.0,,333312
R0008064,2024,1439600,1154400,2594000,96453.0,,170113
R0008065,2024,1136700,831300,1968000,76159.0,,128171
R0008067,2024,1168800,810000,1978800,78310.0,,128895
R0008068,2024,1204500,851500,2056000,80702.0,,134067
R0008069,2024,373300,909200,1282500,25011.0,,82243
R0008070,2024,510000,1035100,1545100,34170.0,,99837
R0008072,2024,820000,1175700,1995700,54940.0,,130027
R0008074,2024,713300,834400,1547700,47791.0,,100011
R0008075,2024,1006900,1100100,2107000,67462.0,,137484
R0008079,2024,970900,674100,1645000,65050.0,,106530
R0008081,2024,3030000,1496900,4526900,203010.0,,299617
R0008085,2024,604500,1384100,1988600,40502.0,,129551
R0008088,2024,450100,813000,1263100,30157.0,,80943
R0008089,2024,263800,1179800,1443600,17675.0,,93036
R0008092,2024,674700,803500,1478200,45205.0,,95354
R0008093,2024,465100,1727800,2192900,31162.0,,143239
R0008095,2024,530700,846300,1377000,35557.0,,88574
R0008096,2024,857800,1659000,2516800,57473.0,,164941
R0008101,2024,122400,825000,947400,8201.0,,59791
R0008106,2024,413400,655800,1069200,27698.0,,67951
R0008108,2024,678200,2729600,3407800,45439.0,,224638
R0008111,2024,1173800,870200,2044000,78645.0,,133263
R0008112,2024,925700,819300,1745000,62022.0,,113230
R0008113,2024,358800,1371200,1730000,24040.0,,112225
R0008117,2024,685800,891600,1577400,42264.0,,102001
R0008118,2024,679322,955200,1634522,45514.0,,105828
R0008121,2024,1007300,1118900,2126200,67489.0,,138770
R0008123,2024,263400,1044200,1307600,17648.0,,83924
R0008125,2024,1150400,2313800,3464200,77077.0,,228416
R0008127,2024,368800,1030200,1399000,24710.0,,90048
R0008131,2024,705000,798900,1503900,47235.0,,97076
R0008132,2024,771700,868300,1640000,48019.0,,106195
R0008138,2024,699400,1858900,2558300,46860.0,,167721
R0008139,2024,506900,1665000,2171900,33962.0,,141832
R0008142,2024,331200,742500,1073700,22190.0,,68253
R0008144,2024,1041100,880000,1921100,69754.0,,125029
R0008145,2024,949400,869300,1818700,63610.0,,118168
R0008155,2024,917900,1933100,2851000,61499.0,,187332
R0008162,2024,251800,683200,935000,13186.0,,58960
R0008166,2024,874300,842800,1717100,58578.0,,111361
R0008167,2024,1904300,2342800,4247100,127588.0,,280871
R0008170,2024,1020800,750900,1771700,68394.0,,115019
R0008171,2024,100670,906030,1006700,6745.0,,63764
R0008178,2024,1194600,1497600,2692200,80038.0,,176692
R0008179,2024,1005900,1708500,2714400,67395.0,,178180
R0008180,2024,3275475,2200900,5476375,219457.0,,363232
R0008186,2024,1461800,1118900,2580700,97941.0,,169222
R0008189,2024,304500,1046400,1350900,20402.0,,86825
R0008190,2024,1542200,1741300,3283500,103327.0,,216310
R0008193,2024,827300,1045100,1872400,55429.0,,121766
R0008194,2024,1123600,1517500,2641100,75281.0,,173269
R0008195,2024,1438200,1692600,3130800,96359.0,,206079
R0008196,2024,929600,1589800,2519400,58598.0,,165115
R0008198,2024,393400,832000,1225400,26358.0,,78417
R0008200,2024,2075300,2604600,4679900,139045.0,,309868
R0008201,2024,345300,1855400,2200700,23135.0,,143762
R0008203,2024,834400,668600,1503000,55905.0,,97016
R0008207,2024,870100,1916200,2786300,58297.0,,182997
R0008213,2024,897900,1405600,2303500,60159.0,,150650
R0008218,2024,340300,704800,1045100,22800.0,,66337
R0008221,2024,675600,1249900,1925500,41581.0,,125324
R0008226,2024,492700,2010700,2503400,33011.0,,164043
R0008227,2024,296790,2671110,2967900,19885.0,,195164
R0008228,2024,282100,790100,1072200,18901.0,,68152
R0008229,2024,748500,801400,1549900,50150.0,,100158
R0008231,2024,497300,1010300,1507600,33319.0,,97324
R0008239,2024,1567650,2262900,3830550,105033.0,,252962
R0008241,2024,767400,1710300,2477700,51416.0,,162321
R0008242,2024,939400,887300,1826700,62940.0,,118704
R0008244,2024,706100,2689700,3395800,47309.0,,223834
R0008245,2024,2033500,1506800,3540300,136245.0,,233515
R0008250,2024,444300,1019700,1464000,29768.0,,94403
R0008251,2024,135300,790300,925600,9065.0,,58330
R0008252,2024,144900,905100,1050000,9708.0,,66665
R0008253,2024,745000,827200,1572200,46230.0,,101652
R0008254,2024,2241200,1565400,3806600,150160.0,,251357
R0008258,2024,288900,889600,1178500,15672.0,,75275
R0008260,2024,166000,1494000,1660000,11122.0,,107535
R0008263,2024,1048300,738600,1786900,70236.0,,116037
R0008268,2024,359400,952200,1311600,24080.0,,84192
R0008269,2024,430500,799400,1229900,28844.0,,78718
R0008270,2024,1265800,1660700,2926500,84809.0,,192391
R0008275,2024,2344200,1955900,4300100,157061.0,,284422
R0008276,2024,269900,870600,1140500,18083.0,,72729
R0008277,2024,332900,723100,1056000,22304.0,,67067
R0008278,2024,309300,941200,1250500,20723.0,,80099
R0008280,2024,369600,914000,1283600,24763.0,,82316
R0008281,2024,507300,669100,1176400,33989.0,,75134
R0008283,2024,1133820,755880,1889700,75966.0,,122925
R0008284,2024,415600,1047200,1462800,27845.0,,94323
R0008285,2024,1085300,1005700,2091000,72715.0,,136412
R0008286,2024,766100,841800,1607900,51329.0,,104044
R0008287,2024,821900,840200,1662100,55067.0,,107676
R0008290,2024,513800,977200,1491000,34425.0,,96212
R0008294,2024,577400,933500,1510900,38686.0,,97545
R0008296,2024,852200,842700,1694900,57097.0,,109873
R0008300,2024,602000,1359300,1961300,40334.0,,127722
R0008305,2024,364200,894800,1259000,20716.0,,80668
R0008308,2024,1368600,1173600,2542200,91696.0,,166642
R0008309,2024,1268300,996700,2265000,84976.0,,148070
R0008310,2024,528800,1060700,1589500,35430.0,,102812
R0008314,2024,940800,2263200,3204000,63034.0,,210983
R0008318,2024,197162,210175,407337,13210.0,,25449
R0008319,2024,1640400,838300,2478700,109907.0,,162388
R0008323,2024,1490000,1557100,3047100,99830.0,,200471
R0008326,2024,2679000,2676500,5355500,179493.0,,355134
R0008330,2024,3915900,1623000,5538900,262365.0,,367421
R0008334,2024,175070,1575630,1750700,11730.0,,113612
R0008337,2024,893900,1579900,2473800,59891.0,,162060
R0008339,2024,913100,1064300,1977400,61178.0,,128801
R0008340,2024,715300,1057600,1772900,47925.0,,115099
R0008343,2024,98880,889920,988800,6625.0,,62565
R0008347,2024,4272100,1543000,5815100,286231.0,,385927
R0008349,2024,1908600,1369700,3278300,127876.0,,215961
R0008350,2024,519200,958300,1477500,34786.0,,95308
R0008351,2024,470700,653600,1124300,31537.0,,71643
R0008362,2024,1051100,859000,1910100,70424.0,,124292
R0008365,2024,472900,886600,1359500,31684.0,,87402
R0008370,2024,1638200,2531700,4169900,109759.0,,275698
R0008371,2024,174500,778100,952600,11692.0,,60139
R0008372,2024,1423000,1374000,2797000,95341.0,,183714
R0008375,2024,332000,1448200,1780200,22244.0,,115588
R0008379,2024,117130,1054170,1171300,7848.0,,74792
R0008380,2024,1090800,1027100,2117900,73084.0,,138214
R0008381,2024,1680101,987900,2668001,112567.0,,175071
R0008385,2024,1003200,836400,1839600,67214.0,,119568
R0008390,2024,2140400,1641200,3781600,143407.0,,249682
R0008394,2024,369000,754200,1123200,24723.0,,71569
R0008400,2024,817700,935500,1753200,54786.0,,113779
R0008404,2024,732100,1188200,1920300,49051.0,,124975
R0008405,2024,130630,1175670,1306300,8752.0,,83837
R0008406,2024,359700,850300,1210000,24100.0,,77385
R0008408,2024,1373100,1123500,2496600,91998.0,,163587
R0008409,2024,307200,708100,1015300,20582.0,,64340
R0008412,2024,603600,870300,1473900,40441.0,,95066
R0008413,2024,193400,931300,1124700,12958.0,,71670
R0008415,2024,654400,859700,1514100,43845.0,,97760
R0008417,2024,1164200,1048500,2212700,78001.0,,144566
R0008425,2024,1037000,906800,1943800,69479.0,,126550
R0008426,2024,509600,828600,1338200,34144.0,,85974
R0008428,2024,1485600,920700,2406300,99535.0,,157537
R0008433,2024,203490,1831410,2034900,13634.0,,132653
R0008435,2024,102860,925740,1028600,6892.0,,65231
R0008440,2024,116810,1051290,1168100,7826.0,,74578
R0008441,2024,475200,1027700,1502900,31838.0,,97009
R0008442,2024,1830400,988100,2818500,122637.0,,185155
R0008447,2024,852200,1350300,2202500,57097.0,,143883
R0008451,2024,566700,840800,1407500,37969.0,,90618
R0008452,2024,447500,978700,1426200,29983.0,,91870
R0008457,2024,391300,1244900,1636200,26217.0,,105940
R0008458,2024,581000,2540900,3121900,38927.0,,205482
R0008460,2024,549700,715300,1265000,33145.0,,81070
R0008461,2024,801100,798000,1599100,53674.0,,103455
R0008462,2024,476000,1314000,1790000,31892.0,,116245
R0008463,2024,518000,777000,1295000,31021.0,,83080
R0008464,2024,486800,1344500,1831300,32616.0,,119012
R0008465,2024,662200,854600,1516800,44367.0,,97941
R0008470,2024,3027000,3638900,6665900,202809.0,,442930
R0008471,2024,892400,1048200,1940600,59791.0,,126335
R0008476,2024,302800,1106600,1409400,20288.0,,90745
R0008484,2024,379800,981400,1361200,25447.0,,87515
R0008490,2024,1784800,2083800,3868600,119582.0,,255511
R0008491,2024,2389200,1929900,4319100,160076.0,,285695
R0008496,2024,280900,613400,894300,18820.0,,56233
R0008499,2024,556600,1585800,2142400,37292.0,,139856
R0008503,2024,3737700,1241400,4979100,250426.0,,329915
R0008505,2024,105450,949050,1054500,7065.0,,66967
R0008510,2024,460500,1969000,2429500,30854.0,,159092
R0008514,2024,626700,827700,1454400,41989.0,,93760
R0008515,2024,521300,1218900,1740200,34927.0,,112908
R0008518,2024,501000,869800,1370800,33567.0,,88159
R0008519,2024,248700,1319400,1568100,16663.0,,101378
R0008521,2024,716400,838300,1554700,47999.0,,100480
R0008523,2024,788800,1129900,1918700,52850.0,,124868
R0008525,2024,2098200,1055200,3153400,140579.0,,207593
R0008526,2024,362100,927200,1289300,24261.0,,82698
R0008529,2024,192100,1165300,1357400,12871.0,,87261
R0008531,2024,1760500,1866600,3627100,117954.0,,239331
R0008534,2024,109260,983340,1092600,7320.0,,69519
R0008535,2024,106570,959130,1065700,7140.0,,67717
R0008537,2024,611200,1183100,1794300,40950.0,,116533
R0008539,2024,810000,1421200,2231200,54270.0,,145805
R0008541,2024,534800,1306100,1840900,35832.0,,119655
R0008542,2024,546400,808200,1354600,36609.0,,87073
R0008543,2024,1213000,966600,2179600,81271.0,,142348
R0008545,2024,164600,935200,1099800,11028.0,,70002
R0008546,2024,2312400,2061600,4374000,154931.0,,289373
R0008549,2024,627100,899600,1526700,42016.0,,98604
R0008551,2024,922600,832600,1755200,61814.0,,113913
R0008553,2024,843700,721900,1565600,56528.0,,101210
R0008554,2024,193400,987000,1180400,12958.0,,75402
R0008557,2024,121400,1065300,1186700,8134.0,,75824
R0008567,2024,4778800,1517800,6296600,320180.0,,418187
R0008570,2024,1024500,1210400,2234900,68642.0,,146053
R0008579,2024,802500,1500600,2303100,53768.0,,150623
R0008580,2024,249700,859600,1109300,16730.0,,70638
R0008582,2024,559000,892200,1451200,37453.0,,93545
R0008583,2024,653600,1804100,2457700,43791.0,,160981
R0008584,2024,822700,1024400,1847100,55121.0,,120071
R0008586,2024,461100,1470600,1931700,27209.0,,125739
R0008591,2024,1203400,824700,2028100,80628.0,,132198
R0008596,2024,122700,837500,960200,8221.0,,60648
R0008598,2024,606100,1014000,1620100,40609.0,,104862
R0008606,2024,574200,1496100,2070300,38471.0,,135025
R0008611,2024,623100,884500,1507600,41748.0,,97324
R0008615,2024,521500,1013000,1534500,34941.0,,99127
R0008618,2024,2610600,2356500,4967100,174910.0,,329111
R0008625,2024,828200,751800,1580000,55489.0,,102175
R0008630,2024,999800,1528500,2528300,66987.0,,165711
R0008633,2024,3033000,1402700,4435700,203211.0,,293507
R0008647,2024,723800,865300,1589100,48495.0,,102785
R0008648,2024,474500,795400,1269900,31792.0,,81398
R0008650,2024,177750,1599750,1777500,11909.0,,115408
R0008651,2024,290120,2611080,2901200,19438.0,,190695
R0008656,2024,1079800,1068700,2148500,72346.0,,140265
R0008661,2024,2789100,1497500,4286600,186870.0,,283517
R0008664,2024,176700,1590300,1767000,11839.0,,114704
R0008671,2024,997100,1355600,2352700,66806.0,,153946
R0008672,2024,1321900,1178100,2500000,88567.0,,163815
R0008673,2024,188600,730600,919200,12636.0,,57901
R0008674,2024,462000,1367600,1829600,30954.0,,118898
R0008676,2024,736400,894100,1630500,49339.0,,105559
R0008677,2024,238250,2144250,2382500,15963.0,,155943
R0008679,2024,1474200,1146600,2620800,98771.0,,171909
R0008680,2024,1067100,1207300,2274400,71496.0,,148700
R0008685,2024,650600,881600,1532200,43590.0,,98972
R0008689,2024,130240,1172160,1302400,8726.0,,83576
R0008694,2024,516000,819900,1335900,34572.0,,85820
R0008698,2024,1152500,829600,1982100,77218.0,,129116
R0008699,2024,255300,1011500,1266800,17105.0,,81191
R0008700,2024,934800,1525500,2460300,62632.0,,161155
R0008702,2024,134700,1075800,1210500,9025.0,,77419
R0008703,2024,248000,1103200,1351200,16616.0,,86845
R0008705,2024,1817200,1754400,3571600,121752.0,,235612
R0008708,2024,1085600,832900,1918500,72735.0,,124855
R0008712,2024,617600,870800,1488400,41379.0,,96038
R0008717,2024,1212300,1029500,2241800,81224.0,,146516
R0008720,2024,431400,1302600,1734000,28904.0,,112493
R0008725,2024,269600,721900,991500,18063.0,,62746
R0008738,2024,606500,692600,1299100,40636.0,,83355
R0008740,2024,980200,952200,1932400,65673.0,,125786
R0008744,2024,485700,1012400,1498100,32542.0,,96688
R0008752,2024,3250700,1478300,4729000,214112.0,,313158
R0008754,2024,1127400,865200,1992600,75536.0,,129819
R0008756,2024,1299600,1394400,2694000,87073.0,,176813
R0008757,2024,1716800,1001100,2717900,115026.0,,178414
R0008765,2024,1364400,896800,2261200,91415.0,,147815
R0008766,2024,357500,1101300,1458800,23953.0,,94055
R0008775,2024,516800,1271000,1787800,34626.0,,116098
R0008776,2024,387300,892800,1280100,25949.0,,82082
R0008782,2024,2208700,1290400,3499100,147983.0,,230755
R0008783,2024,893300,1071600,1964900,59851.0,,127963
R0008784,2024,699000,466000,1165000,46833.0,,74370
R0008785,2024,304900,810300,1115200,20428.0,,71033
R0008788,2024,801000,1040100,1841100,53667.0,,119669
R0008791,2024,277800,899000,1176800,18613.0,,75161
R0008793,2024,1377600,856400,2234000,92299.0,,145993
R0008794,2024,993300,842400,1835700,66551.0,,119307
R0008795,2024,486100,1118000,1604100,32569.0,,103790
R0008799,2024,1759900,1253700,3013600,117913.0,,198226
R0008800,2024,1574700,1278400,2853100,105505.0,,187473
R0008802,2024,1702400,1549800,3252200,114061.0,,214212
R0008803,2024,773800,1048300,1822100,51845.0,,118396
R0008804,2024,129660,1166940,1296600,8687.0,,83187
R0008805,2024,186400,1677600,1864000,12489.0,,121203
R0008806,2024,96456,1654830,1751286,6463.0,,113651
R0008807,2024,2320800,2108300,4429100,155494.0,,293065
R0008811,2024,960300,832000,1792300,64340.0,,116399
R0008812,2024,333700,564900,898600,22358.0,,56521
R0008813,2024,935100,835300,1770400,62652.0,,114932
R0008819,2024,155670,1401030,1556700,10430.0,,100614
R0008821,2024,414800,692500,1107300,27792.0,,70504
R0008824,2024,5350500,2652700,8003200,358484.0,,532529
R0008832,2024,513100,969000,1482100,34378.0,,95616
R0008833,2024,278200,918800,1197000,18639.0,,76514
R0008834,2024,311500,853600,1165100,20871.0,,74377
R0008835,2024,819700,863800,1683500,54920.0,,109110
R0008836,2024,1531000,1220600,2751600,102577.0,,180672
R0008839,2024,570200,1173000,1743200,38203.0,,113109
R0008841,2024,743400,833600,1577000,49808.0,,101974
R0008851,2024,1813300,1089100,2902400,121491.0,,190776
R0008855,2024,1005900,880300,1886200,67395.0,,122690
R0008863,2024,678900,691100,1370000,41801.0,,88105
R0008872,2024,601500,837500,1439000,40301.0,,92728
R0008885,2024,529500,1356500,1886000,35477.0,,122677
R0008891,2024,1071800,912300,1984100,71811.0,,129250
R0008893,2024,399800,599700,999500,23102.0,,63282
R0008894,2024,2567700,1226000,3793700,172036.0,,250493
R0008901,2024,1236500,1215200,2451700,82846.0,,160579
R0008904,2024,1158700,1267100,2425800,77633.0,,158844
R0008908,2024,344200,839200,1183400,23061.0,,75603
R0008911,2024,464300,1025800,1490100,31108.0,,96152
R0008912,2024,322600,1138800,1461400,21614.0,,94229
R0008917,2024,1249100,2110700,3359800,83690.0,,221422
R0008918,2024,376600,833100,1209700,25232.0,,77365
R0008924,2024,166430,1497870,1664300,11151.0,,107823
R0008932,2024,796200,835300,1631500,49661.0,,105626
R0008933,2024,756600,1456400,2213000,50692.0,,144586
R0008935,2024,476700,1354700,1831400,31939.0,,119019
R0008936,2024,893200,1082500,1975700,59844.0,,128687
R0008937,2024,1224300,835000,2059300,82028.0,,134288
R0008938,2024,2001600,2034800,4036400,134107.0,,266754
R0008939,2024,303400,527500,830900,20328.0,,51985
R0008940,2024,567700,979400,1547100,38036.0,,99971
R0008942,2024,699400,1387600,2087000,46860.0,,136144
R0008946,2024,131200,1119100,1250300,8790.0,,80085
R0008950,2024,352600,866900,1219500,23624.0,,78022
R0008951,2024,352000,1038300,1390300,23584.0,,89465
R0008953,2024,481800,1054800,1536600,32281.0,,99267
R0008955,2024,637900,732300,1370200,42739.0,,88118
R0008956,2024,824000,1019800,1843800,55208.0,,119850
R0008961,2024,1648700,1082300,2731000,110463.0,,179292
R0008962,2024,823200,1236900,2060100,55154.0,,134342
R0008964,2024,714600,831600,1546200,47878.0,,99910
R0008965,2024,545500,1466600,2012100,36549.0,,131126
R0008968,2024,413000,726300,1139300,27671.0,,72648
R0008969,2024,279000,748900,1027900,18693.0,,65184
R0008971,2024,808800,1656900,2465700,54190.0,,161517
R0008975,2024,1374100,1038700,2412800,92065.0,,157973
R0008979,2024,716000,958200,1674200,47972.0,,108486
R0008980,2024,1084900,993900,2078800,72688.0,,135595
R0008984,2024,516400,852800,1369200,34599.0,,88051
R0008990,2024,186700,1610500,1797200,12509.0,,116727
R0008994,2024,1412000,1045200,2457200,94604.0,,160947
R0008996,2024,456100,967500,1423600,30559.0,,91696
R0008998,2024,2172800,2484000,4656800,145578.0,,308321
R0008999,2024,480700,1145100,1625800,32207.0,,105244
R0009002,2024,141800,1276200,1418000,9501.0,,91321
R0009006,2024,358300,1238600,1596900,24006.0,,103307
R0009007,2024,689100,1156400,1845500,46170.0,,119964
R0009008,2024,671400,1999600,2671000,44984.0,,175272
R0009009,2024,508800,1362900,1871700,34090.0,,121719
R0009013,2024,424900,1117000,1541900,28468.0,,99622
R0009014,2024,327500,1138300,1465800,21943.0,,94524
R0009015,2024,880000,1186500,2066500,58960.0,,134771
R0009021,2024,402600,1026900,1429500,26974.0,,92092
R0009023,2024,636100,891100,1527200,42619.0,,98637
R0009024,2024,632500,833700,1466200,42378.0,,94550
R0009025,2024,1696600,1270600,2967200,113672.0,,195117
R0009026,2024,1727000,1343800,3070800,115709.0,,202059
R0009030,2024,172770,1554930,1727700,11576.0,,112071
R0009032,2024,2031600,2209500,4241100,136117.0,,280469
R0009035,2024,371500,810000,1181500,21206.0,,75476
R0009036,2024,484200,1032900,1517100,32441.0,,97961
R0009037,2024,207230,1865070,2072300,13884.0,,135159
R0009038,2024,249630,2246670,2496300,16725.0,,163567
R0009039,2024,787100,1316700,2103800,49051.0,,137270
R0009041,2024,749100,837700,1586800,50190.0,,102631
R0009042,2024,2404050,1994400,4398450,161071.0,,291011
R0009049,2024,880600,2033100,2913700,59000.0,,191533
R0009050,2024,283600,1175600,1459200,19001.0,,94081
R0009052,2024,664800,799100,1463900,44542.0,,94396
R0009059,2024,500800,1125400,1626200,33554.0,,105270
R0009060,2024,124380,1119420,1243800,8333.0,,79650
R0009061,2024,1524600,2123400,3648000,102148.0,,240731
R0009062,2024,881400,975800,1857200,59054.0,,120747
R0009063,2024,954400,1315900,2270300,63945.0,,148425
R0009067,2024,773100,946800,1719900,51798.0,,111548
R0009069,2024,949600,526200,1475800,63623.0,,95194
R0009070,2024,2013300,1053700,3067000,134891.0,,201804
R0009074,2024,659900,1565900,2225800,44213.0,,145444
R0009081,2024,412900,964900,1377800,23980.0,,88628
R0009082,2024,1693300,1250800,2944100,113451.0,,193570
R0009089,2024,933500,1081900,2015400,62545.0,,131347
R0009091,2024,739100,658900,1398000,49520.0,,89981
R0009094,2024,945800,961600,1907400,63369.0,,124111
R0009095,2024,126500,845000,971500,8475.0,,61406
R0009096,2024,733700,682300,1416000,49158.0,,91187
R0009097,2024,499900,549900,1049800,33493.0,,66652
R0009100,2024,666300,1230300,1896600,44642.0,,123387
R0009101,2024,165300,755000,920300,11075.0,,57975
R0009106,2024,1401500,1053900,2455400,93901.0,,160827
R0009107,2024,89620,806580,896200,6005.0,,56360
R0009114,2024,1530400,1569200,3099600,102537.0,,203988
R0009118,2024,463400,647300,1110700,31048.0,,70732
R0009125,2024,755200,771800,1527000,50598.0,,98624
R0009128,2024,452300,551700,1004000,30304.0,,63583
R0009131,2024,232140,2089260,2321400,15553.0,,151849
R0009142,2024,693700,1489200,2182900,46478.0,,142569
R0009145,2024,1246900,1953700,3200600,83542.0,,210755
R0009154,2024,500300,503000,1003300,33520.0,,63536
R0009155,2024,773900,1054300,1828200,51851.0,,118804
R0009156,2024,777900,929000,1706900,52119.0,,110677
R0009160,2024,428600,1264400,1693000,28716.0,,109746
R0009163,2024,491500,946100,1437600,32931.0,,92634
R0009164,2024,1120300,2044300,3164600,75060.0,,208343
R0009165,2024,1924400,1758800,3683200,128935.0,,243089
R0009169,2024,3533100,1454600,4987700,236718.0,,330491
R0009175,2024,1596800,1498100,3094900,103300.0,,203673
R0009177,2024,935600,2436100,3371700,62685.0,,222219
R0009179,2024,914800,1565400,2480200,61292.0,,162488
R0009186,2024,85350,768150,853500,5718.0,,53500
R0009190,2024,96450,868050,964500,6462.0,,60937
R0009197,2024,1570900,836700,2407600,105250.0,,157624
R0009199,2024,1037000,860100,1897100,69479.0,,123421
R0009203,2024,1175900,1015600,2191500,78785.0,,143146
R0009205,2024,310400,2280500,2590900,20797.0,,169905
R0009207,2024,779200,1674400,2453600,52206.0,,160706
R0009208,2024,309300,1048100,1357400,20723.0,,87261
R0009209,2024,566900,1006900,1573800,37982.0,,101760
R0009214,2024,853000,2055100,2908100,57151.0,,191158
R0033017,2024,4458389,4629300,9087689,298712.0,,605190
R0033046,2024,620700,1452000,2072700,37902.0,,135186
R0033059,2024,1308300,3240100,4548400,87656.0,,301058
R0033069,2024,191450,1723050,1914500,12827.0,,124587
R0033111,2024,385300,1741900,2127200,25815.0,,138837
R0033156,2024,255610,2300490,2556100,17126.0,,167574
R0033213,2024,412190,3709710,4121900,27617.0,,272482
R0033218,2024,364800,547100,911900,20756.0,,57412
R0033317,2024,201080,1809720,2010800,13472.0,,131039
R0033326,2024,1176000,1764000,2940000,75107.0,,193295
R0033345,2024,1850600,3015400,4866000,123990.0,,322337
R0033350,2024,2447800,3123400,5571200,164003.0,,369585
R0033380,2024,576225,5675700,6251925,38607.0,,415194
R0033395,2024,1436100,4175800,5611900,96219.0,,372312
R0033397,2024,2419600,6585700,9005300,162113.0,,599670
R0033399,2024,1393600,2090400,3484000,89686.0,,229743
R0033403,2024,479110,4311990,4791100,32100.0,,317319
R0033428,2024,194390,1749510,1943900,13024.0,,126556
R0033445,2024,4650900,5003600,9654500,311610.0,,643167
R0033482,2024,170640,1535760,1706400,11433.0,,110644
R0033496,2024,1259000,1237700,2496700,84353.0,,163594
R0033508,2024,171700,1061200,1232900,11504.0,,78919
R0033525,2024,393260,3539340,3932600,26348.0,,259799
R0033535,2024,374080,3366720,3740800,25063.0,,246949
R0033579,2024,3151365,4396600,7547965,211141.0,,502029
R0033598,2024,309900,2789100,3099000,20763.0,,203948
R0033608,2024,386100,862900,1249000,25869.0,,79998
R0035007,2024,1460100,2578300,4038400,97827.0,,266888
R0035008,2024,245860,2212740,2458600,16473.0,,161041
R0035009,2024,4533500,3070300,7603800,303745.0,,505770
R0035010,2024,1643300,2208300,3851600,110101.0,,254372
R0035011,2024,2080100,2091000,4171100,139367.0,,275779
R0035012,2024,1986000,1949600,3935600,133062.0,,260000
R0035013,2024,1649000,1874300,3523300,110483.0,,232376
R0035014,2024,602700,2295900,2898600,40381.0,,190521
R0035016,2024,2450200,2113300,4563500,164163.0,,302070
R0035017,2024,2770400,2239000,5009400,185617.0,,331945
R0035018,2024,659500,2361100,3020600,44187.0,,198695
R0035019,2024,1972300,2153900,4126200,132144.0,,272770
R0035020,2024,1207000,2729700,3936700,80869.0,,260074
R0035021,2024,278870,2509830,2788700,18684.0,,183158
R0035022,2024,887700,1866600,2754300,59476.0,,180853
R0035023,2024,929500,2305300,3234800,62277.0,,213047
R0035024,2024,3346000,3586000,6932000,224182.0,,460759
R0035025,2024,493325,2147200,2640525,33053.0,,173230
R0035026,2024,2602120,2502500,5104620,174342.0,,338325
R0035027,2024,226880,2041920,2268800,15201.0,,148325
R0035028,2024,875400,2511300,3386700,58652.0,,223224
R0035029,2024,2085500,2245900,4331400,139729.0,,286519
R0035030,2024,1752900,2173100,3926000,117444.0,,259357
R0035031,2024,1340000,2400300,3740300,89780.0,,246915
R0035032,2024,2398700,1933000,4331700,160713.0,,286539
R0035033,2024,1956500,2041900,3998400,131086.0,,264208
R0035034,2024,657000,1778200,2435200,44019.0,,159473
R0035035,2024,2501300,2568800,5070100,167587.0,,336012
R0035036,2024,1691800,2189200,3881000,113351.0,,256342
R0035037,2024,1225000,2006900,3231900,82075.0,,212852
R0035038,2024,3194400,2152400,5346800,214025.0,,354551
R0035039,2024,1243800,1789300,3033100,83335.0,,199533
R0035040,2024,2136100,2616000,4752100,143119.0,,314706
R0035041,2024,2795600,2738300,5533900,187305.0,,367086
R0035042,2024,235020,2115180,2350200,15746.0,,153778
R0035043,2024,232700,1407300,1640000,15591.0,,106195
R0035044,2024,657900,2159700,2817600,44079.0,,185094
R0035045,2024,236240,2738600,2974840,15828.0,,195629
R0035046,2024,1166500,2411500,3578000,78156.0,,236041
R0035047,2024,5306400,2666800,7973200,355529.0,,530519
R0035048,2024,1054100,1595900,2650000,66940.0,,173865
R0035050,2024,513200,450100,963300,34384.0,,60856
R0035051,2024,429900,458600,888500,28803.0,,55845
R0035053,2024,700400,822300,1522700,46927.0,,98336
R0035054,2024,662100,2923916,3586016,44361.0,,236578
R0035055,2024,893200,2826600,3719800,59844.0,,245542
R0035056,2024,604300,2903700,3508000,40488.0,,231351
R0035057,2024,659300,2533500,3192800,44173.0,,210233
R0035058,2024,4825500,2934600,7760100,323309.0,,516242
R0060487,2024,1637900,1633800,3271700,109739.0,,215519
R0062395,2024,1295600,1808800,3104400,86805.0,,204310
R0062753,2024,1196700,1219300,2416000,80179.0,,158187
R0062762,2024,184500,976600,1161100,12362.0,,74109
R0062832,2024,983500,819900,1803400,65895.0,,117143
R0062911,2024,197163,210175,407338,13210.0,,25449
R0063070,2024,359400,775800,1135200,24080.0,,72373
R0066013,2024,1462100,955900,2418000,97961.0,,158321
R0066599,2024,709900,2575500,3285400,47563.0,,216437
R0066966,2024,1253300,1462800,2716100,83971.0,,178294
R0067632,2024,140230,1262070,1402300,9395.0,,90269
R0067690,2024,2017700,1137000,3154700,135186.0,,207680
R0067740,2024,114330,1028970,1143300,7660.0,,72916
R0067777,2024,477600,1271600,1749200,31999.0,,113511
R0067805,2024,657000,1212600,1869600,44019.0,,121578
R0067883,2024,1772400,944000,2716400,118751.0,,178314
R0068335,2024,108130,973170,1081300,7245.0,,68762
R0068415,2024,1310200,1240800,2551000,87783.0,,167232
R0068590,2024,956500,820100,1776600,60400.0,,115347
R0068597,2024,400100,764100,1164200,26807.0,,74316
R0068778,2024,977000,694500,1671500,65459.0,,108306
R0068781,2024,692800,875100,1567900,46418.0,,101364
R0068782,2024,889600,857600,1747200,59603.0,,113377
R0068783,2024,744500,937600,1682100,49882.0,,109016
R0069065,2024,801500,891100,1692600,53701.0,,109719
R0069338,2024,123260,1109340,1232600,8258.0,,78899
R0069354,2024,365800,1486600,1852400,24509.0,,120426
R0071420,2024,1241100,1346700,2587800,83154.0,,169698
R0071841,2024,696500,888200,1584700,46666.0,,102490
R0071842,2024,649500,850900,1500400,43517.0,,96842
R0071843,2024,641300,879700,1521000,42967.0,,98222
R0071844,2024,873400,856300,1729700,58518.0,,112205
R0072006,2024,460600,839400,1300000,30861.0,,83415
R0072179,2024,705200,1144100,1849300,47248.0,,120218
R0072218,2024,1377400,1464800,2842200,92286.0,,186742
R0073918,2024,833200,431300,1264500,55824.0,,81037
R0073919,2024,691000,412300,1103300,46297.0,,70236
R0073920,2024,727500,412300,1139800,48743.0,,72682
R0073921,2024,674500,437500,1112000,45192.0,,70819
R0073922,2024,802500,439800,1242300,53768.0,,79549
R0073923,2024,710600,431600,1142200,47610.0,,72842
R0073924,2024,627900,410200,1038100,42069.0,,65868
R0073925,2024,763000,436500,1199500,51121.0,,76682
R0073926,2024,685800,408800,1094600,45949.0,,69653
R0073927,2024,763200,452300,1215500,51134.0,,77754
R0073928,2024,739400,419200,1158600,49540.0,,73941
R0073930,2024,747100,408800,1155900,50056.0,,73760
R0073931,2024,856700,428600,1285300,57399.0,,82430
R0073932,2024,750000,439200,1189200,50250.0,,75991
R0075737,2024,1026400,497800,1524200,68769.0,,98436
R0075929,2024,374000,842700,1216700,25058.0,,77834
R0075941,2024,233800,947700,1181500,15665.0,,75476
R0076481,2024,821300,1108500,1929800,55028.0,,125612
R0077684,2024,440300,455800,896100,29500.0,,56354
R0077685,2024,447500,454200,901700,29983.0,,56729
R0078842,2024,1672600,2148900,3821500,112064.0,,252356
R0080504,2024,652900,485600,1138500,43744.0,,72595
R0080505,2024,712900,477300,1190200,47764.0,,76058
R0080507,2024,721400,479900,1201300,48334.0,,76802
R0080508,2024,586000,478800,1064800,39262.0,,67657
R0080693,2024,936200,1167900,2104100,62725.0,,137290
R0080721,2024,730800,837700,1568500,48964.0,,101405
R0080781,2024,644100,666900,1311000,43155.0,,84152
R0080782,2024,875700,608100,1483800,54987.0,,95730
R0080783,2024,1190200,1841300,3031500,79743.0,,199426
R0080819,2024,1468700,830200,2298900,98403.0,,150341
R0081023,2024,719600,1319100,2038700,48213.0,,132908
R0081072,2024,2178000,2139400,4317400,145926.0,,285581
R0081546,2024,211600,280200,491800,14177.0,,29266
R0081547,2024,292000,283300,575300,19564.0,,34860
R0081548,2024,240000,282000,522000,16080.0,,31289
R0081549,2024,211200,286800,498000,14150.0,,29681
R0081550,2024,248700,306000,554700,16663.0,,33480
R0081551,2024,245700,306000,551700,16462.0,,33279
R0081552,2024,295700,307600,603300,19812.0,,36736
R0081553,2024,281900,350800,632700,18887.0,,38706
R0081554,2024,297800,303800,601600,19953.0,,36622
R0081555,2024,273300,315000,588300,18311.0,,35731
R0081556,2024,285500,302200,587700,19129.0,,35691
R0081557,2024,299900,306700,606600,20093.0,,36957
R0081558,2024,340800,336000,676800,22834.0,,41661
R0081559,2024,280400,305700,586100,18787.0,,35584
R0081560,2024,306000,295400,601400,20502.0,,36609
R0081561,2024,269400,293200,562600,18050.0,,34009
R0081562,2024,250700,294000,544700,16797.0,,32810
R0081563,2024,308600,325500,634100,20676.0,,38800
R0081564,2024,244900,327300,572200,16408.0,,34652
R0081565,2024,269700,298800,568500,18070.0,,34405
R0081566,2024,325600,343200,668800,21815.0,,41125
R0081567,2024,275900,298100,574000,18485.0,,34773
R0081568,2024,265000,295900,560900,17755.0,,33895
R0081569,2024,255200,332500,587700,17098.0,,35691
R0081570,2024,274200,334700,608900,18371.0,,37111
R0081571,2024,220300,285000,505300,14760.0,,30170
R0081572,2024,214200,274500,488700,14351.0,,29058
R0081573,2024,254500,296900,551400,17052.0,,33259
R0081574,2024,307300,345100,652400,20589.0,,40026
R0081575,2024,249200,308800,558000,16696.0,,33701
R0081576,2024,232800,283800,516600,15598.0,,30927
R0081577,2024,255600,283000,538600,17125.0,,32401
R0081578,2024,246800,334900,581700,16536.0,,35289
R0081580,2024,253000,313800,566800,16951.0,,34291
R0081581,2024,278400,295400,573800,18653.0,,34760
R0081582,2024,319600,344600,664200,21413.0,,40816
R0081583,2024,279400,296600,576000,18720.0,,34907
R0081584,2024,384200,334700,718900,25741.0,,44481
R0081585,2024,308000,337500,645500,20636.0,,39564
R0081586,2024,257200,297600,554800,17232.0,,33487
R0081587,2024,277400,356100,633500,18586.0,,38760
R0081588,2024,304800,301200,606000,16737.0,,36917
R0081589,2024,310100,305300,615400,20777.0,,37547
R0081590,2024,321300,349000,670300,21527.0,,41225
R0081591,2024,286500,325100,611600,19196.0,,37292
R0081592,2024,280800,319700,600500,18814.0,,36549
R0081593,2024,255000,302600,557600,17085.0,,33674
R0081594,2024,284100,345100,629200,19035.0,,38471
R0081595,2024,263400,302200,565600,17648.0,,34210
R0081596,2024,283000,340000,623000,18961.0,,38056
R0081597,2024,289600,333000,622600,19403.0,,38029
R0081598,2024,262100,321500,583600,17561.0,,35416
R0081599,2024,211100,287000,498100,14144.0,,29688
R0081600,2024,217400,273400,490800,14566.0,,29199
R0081601,2024,258600,294200,552800,17326.0,,33353
R0081602,2024,278000,291300,569300,18626.0,,34458
R0081603,2024,274400,289300,563700,18385.0,,34083
R0081612,2024,407500,885200,1292700,27303.0,,82926
R0081613,2024,1233300,851200,2084500,82631.0,,135977
R0081614,2024,1251800,829300,2081100,83871.0,,135749
R0081615,2024,345800,875100,1220900,23169.0,,78115
R0081616,2024,539800,609200,1149000,36167.0,,73298
R0081617,2024,576800,595700,1172500,38646.0,,74873
R0081618,2024,573300,603600,1176900,38411.0,,75167
R0081619,2024,512800,638800,1151600,34358.0,,73472
R0081620,2024,485600,783100,1268700,32535.0,,81318
R0081621,2024,387050,774700,1161750,25932.0,,74152
R0081622,2024,583300,861800,1445100,39081.0,,93137
R0081623,2024,623600,808600,1432200,41781.0,,92272
R0081624,2024,722300,670700,1393000,48394.0,,89646
R0081625,2024,434900,696000,1130900,29138.0,,72085
R0082165,2024,201400,280500,481900,13494.0,,28602
R0082711,2024,580100,719200,1299300,38867.0,,83368
R0082985,2024,1011200,784700,1795900,67750.0,,116640
R0083693,2024,1514500,885100,2399600,101472.0,,157088
R0083945,2024,729100,1197500,1926600,48850.0,,125397
R0083987,2024,597700,295600,893300,40046.0,,56166
R0083988,2024,712500,293200,1005700,47738.0,,63697
R0083989,2024,714300,295900,1010200,47858.0,,63998
R0084302,2024,1118900,1789500,2908400,74966.0,,191178
R0085109,2024,1605250,1356000,2961250,107552.0,,194719
R0085111,2024,1316600,958500,2275100,88212.0,,148747
R0085125,2024,1196800,1077000,2273800,80186.0,,148660
R0085129,2024,705100,754400,1459500,47242.0,,94102
R0085429,2024,720200,626700,1346900,48253.0,,86557
R0085586,2024,2478300,939600,3417900,166046.0,,225314
R0085701,2024,6672800,2508200,9181000,447078.0,,611442
R0085716,2024,1821300,1972900,3794200,122027.0,,250526
R0085746,2024,446900,681400,1128300,29942.0,,71911
R0086575,2024,677500,678200,1355700,45393.0,,87147
R0086989,2024,474700,1964800,2439500,31805.0,,159762
R0087127,2024,511400,785300,1296700,34264.0,,83194
R0087394,2024,713400,965900,1679300,47798.0,,108828
R0087850,2024,520400,451200,971600,34867.0,,61412
R0087851,2024,644700,424100,1068800,43195.0,,67925
R0088124,2024,832600,708000,1540600,55784.0,,99535
R0088139,2024,895515,618900,1514415,60000.0,,97781
R0088954,2024,522000,656900,1178900,34974.0,,75301
R0089342,2024,559300,655500,1214800,37473.0,,77707
R0089427,2024,772800,740500,1513300,51778.0,,97706
R0089603,2024,73500,375000,448500,4925.0,,26365
R0089661,2024,1053800,699700,1753500,70605.0,,113800
R0090380,2024,670700,778000,1448700,44937.0,,93378
R0090382,2024,1228700,931300,2160000,82323.0,,141035
R0090417,2024,394400,706900,1101300,26425.0,,70102
R0090421,2024,649700,717800,1367500,43529.0,,87938
R0090453,2024,831500,1742200,2573700,55711.0,,168753
R0091016,2024,697300,696600,1393900,43034.0,,89706
R0091017,2024,629300,641100,1270400,42163.0,,81432
R0093134,2024,574500,662600,1237100,38492.0,,79201
R0093185,2024,147300,589000,736300,6184.0,,45647
R0094084,2024,138290,1244610,1382900,9266.0,,88969
R0094540,2024,273600,410400,684000,14646.0,,42143
R0094541,2024,813300,805600,1618900,54491.0,,104781
R0094542,2024,1047000,1050500,2097500,70149.0,,136848
R0094630,2024,736600,760900,1497500,49352.0,,96648
R0094808,2024,636600,564600,1201200,42652.0,,76795
R0095162,2024,572400,724200,1296600,38351.0,,83187
R0095476,2024,1117100,783700,1900800,74846.0,,123669
R0095477,2024,991600,721200,1712800,66437.0,,111073
R0095515,2024,679900,571700,1251600,45553.0,,80172
R0095516,2024,706700,834900,1541600,47349.0,,99602
R0096324,2024,933100,658000,1591100,62518.0,,102919
R0096394,2024,1048200,1034000,2082200,70229.0,,135822
R0096395,2024,1026600,1097000,2123600,68783.0,,138596
R0096446,2024,1440100,1008600,2448700,96487.0,,160378
R0096963,2024,922600,759300,1681900,61814.0,,109002
R0096964,2024,525600,708300,1233900,31530.0,,78986
R0098290,2024,847900,701500,1549400,56809.0,,100125
R0098421,2024,1220800,717600,1938400,81794.0,,126188
R0098424,2024,951300,707900,1659200,63737.0,,107481
R0098549,2024,722500,680100,1402600,48408.0,,90289
R0099011,2024,960100,697200,1657300,64326.0,,107354
R0099049,2024,453000,982400,1435400,30351.0,,92487
R0099096,2024,936400,674000,1610400,62739.0,,104212
R0099223,2024,1610400,2114200,3724600,107897.0,,245863
R0099254,2024,729600,848700,1578300,48883.0,,102061
R0099278,2024,651500,672600,1324100,43651.0,,85030
R0099719,2024,809500,740300,1549800,54237.0,,100152
R0100420,2024,185370,1668330,1853700,12420.0,,120513
R0100750,2024,766900,881000,1647900,51382.0,,106724
R0100751,2024,757400,879600,1637000,50746.0,,105994
R0100769,2024,379300,720700,1100000,25413.0,,70015
R0101006,2024,337700,438700,776400,18941.0,,48334
R0101007,2024,371900,556200,928100,24917.0,,58498
R0101031,2024,801700,934900,1736600,53714.0,,112667
R0101037,2024,1002500,720800,1723300,67168.0,,111776
R0101151,2024,1138400,727000,1865400,76273.0,,121297
R0101564,2024,981700,1404800,2386500,65774.0,,156211
R0101565,2024,1017400,1223100,2240500,68166.0,,146429
R0101566,2024,760500,1224500,1985000,50954.0,,129310
R0101567,2024,1299300,1201200,2500500,87053.0,,163849
R0101631,2024,1055100,1438700,2493800,70692.0,,163400
R0101926,2024,779800,878000,1657800,52247.0,,107388
R0102061,2024,872000,779500,1651500,58424.0,,106966
R0103291,2024,969000,901500,1870500,64923.0,,121639
R0103312,2024,734900,5165100,5900000,49238.0,,391615
R0103777,2024,613300,620900,1234200,41091.0,,79006
R0103863,2024,789700,775200,1564900,52910.0,,101163
R0103865,2024,873400,765400,1638800,58518.0,,106115
R0103995,2024,985300,801700,1787000,66015.0,,116044
R0104220,2024,891600,1252900,2144500,59737.0,,139997
R0104632,2024,608000,629800,1237800,40736.0,,79248
R0104634,2024,710000,671000,1381000,47570.0,,88842
R0105012,2024,863100,835800,1698900,57828.0,,110141
R0105083,2024,1092700,755300,1848000,73211.0,,120131
R0105085,2024,865028,861000,1726028,57957.0,,111959
R0105263,2024,1630800,2033500,3664300,109264.0,,241823
R0105363,2024,866600,1042600,1909200,58062.0,,124231
R0105411,2024,700400,752100,1452500,46927.0,,93633
R0105427,2024,625400,748200,1373600,41902.0,,88346
R0105429,2024,963000,634700,1597700,64521.0,,103361
R0105504,2024,1949600,2003000,3952600,130623.0,,261139
R0105717,2024,602030,718000,1320030,40336.0,,84757
R0105766,2024,651500,771500,1423000,39965.0,,91656
R0105774,2024,816400,740100,1556500,54699.0,,100601
R0105822,2024,1236100,1354300,2590400,82818.0,,169872
R0106164,2024,533900,562900,1096800,35771.0,,69801
R0106189,2024,1530500,883900,2414400,102544.0,,158080
R0106190,2024,1207000,666300,1873300,80869.0,,121826
R0106205,2024,625000,825700,1450700,41875.0,,93512
R0106239,2024,662600,679000,1341600,44394.0,,86202
R0106240,2024,588800,529700,1118500,39450.0,,71255
R0106422,2024,754600,702200,1456800,50558.0,,93921
R0106431,2024,1241200,833800,2075000,79475.0,,135340
R0106446,2024,1254000,828400,2082400,84018.0,,135836
R0106537,2024,634700,677200,1311900,42525.0,,84212
R0106539,2024,751800,735700,1487500,50371.0,,95978
R0106540,2024,1074100,1203600,2277700,71965.0,,148921
R0106551,2024,1336200,836700,2172900,85840.0,,141899
R0106571,2024,713400,519300,1232700,47798.0,,78906
R0106579,2024,781800,747100,1528900,52381.0,,98751
R0106580,2024,679400,795600,1475000,45520.0,,95140
R0106596,2024,1324200,836500,2160700,88721.0,,141082
R0106800,2024,796500,743400,1539900,53366.0,,99488
R0106850,2024,741800,772900,1514700,49701.0,,97800
R0107059,2024,590400,500300,1090700,39557.0,,69392
R0107061,2024,741700,528900,1270600,49694.0,,81445
R0107074,2024,571200,704700,1275900,38270.0,,81800
R0107078,2024,704800,716700,1421500,47222.0,,91556
R0107079,2024,328800,581100,909900,22030.0,,57278
R0107115,2024,598700,555800,1154500,40113.0,,73667
R0107997,2024,803100,693700,1496800,53808.0,,96601
R0108011,2024,1820300,941900,2762200,121960.0,,181382
R0108036,2024,1253800,1360900,2614700,84005.0,,171500
R0108117,2024,790400,1000200,1790600,52957.0,,116285
R0108118,2024,1047700,1055600,2103300,70196.0,,137236
R0108119,2024,1095700,1150700,2246400,73412.0,,146824
R0108120,2024,1261000,1060800,2321800,84487.0,,151876
R0108121,2024,1100500,1190900,2291400,73734.0,,149839
R0108446,2024,952600,744100,1696700,63824.0,,109994
R0108547,2024,650700,1496700,2147400,43597.0,,140191
R0108635,2024,723100,752700,1475800,48448.0,,95194
R0108658,2024,2721200,1984500,4705700,182320.0,,311597
R0108683,2024,1671000,2129000,3800000,111957.0,,250915
R0108741,2024,481100,597300,1078400,32234.0,,68568
R0108752,2024,822300,659700,1482000,55094.0,,95609
R0108768,2024,645500,742500,1388000,43249.0,,89311
R0108772,2024,514800,761200,1276000,34492.0,,81807
R0108775,2024,700400,731500,1431900,46927.0,,92252
R0108777,2024,682600,721900,1404500,45734.0,,90417
R0108778,2024,531300,584100,1115400,35597.0,,71047
R0108780,2024,479800,591200,1071000,32147.0,,68072
R0108838,2024,814900,669800,1484700,54598.0,,95790
R0108901,2024,470800,620200,1091000,31544.0,,69412
R0109349,2024,680900,659400,1340300,45620.0,,86115
R0109352,2024,945500,789200,1734700,63349.0,,112540
R0109669,2024,1287200,1076100,2363300,86242.0,,154656
R0109710,2024,1388200,735300,2123500,93009.0,,138590
R0109758,2024,703300,650800,1354100,47121.0,,87040
R0109759,2024,773200,715300,1488500,51804.0,,96045
R0109760,2024,713800,780800,1494600,47825.0,,96453
R0109761,2024,577900,772100,1350000,38719.0,,86765
R0109762,2024,815200,725200,1540400,54618.0,,99522
R0109763,2024,1074500,1051800,2126300,71992.0,,138777
R0109847,2024,2136100,1663300,3799400,143119.0,,250875
R0109848,2024,1115300,1465500,2580800,74725.0,,169229
R0109863,2024,551500,780900,1332400,36951.0,,85586
R0110106,2024,720900,619800,1340700,48300.0,,86142
R0110118,2024,1224900,1039900,2264800,82068.0,,148057
R0110119,2024,1109800,926900,2036700,74357.0,,132774
R0110120,2024,1065700,918200,1983900,71402.0,,129236
R0110575,2024,692800,802300,1495100,46418.0,,96487
R0110620,2024,1314200,1977600,3291800,88051.0,,216866
R0110621,2024,556600,558600,1115200,37292.0,,71033
R0110622,2024,682000,548600,1230600,45694.0,,78765
R0110777,2024,1354900,884000,2238900,90778.0,,146321
R0111277,2024,817800,747000,1564800,54793.0,,101157
R0111677,2024,552800,748100,1300900,37038.0,,83475
R0111697,2024,755600,1374400,2130000,46940.0,,139025
R0111698,2024,772700,1024600,1797300,48086.0,,116734
R0111699,2024,1224100,1176700,2400800,82015.0,,157169
R0111865,2024,860500,660200,1520700,57654.0,,98202
R0111981,2024,1126800,660400,1787200,75496.0,,116057
R0112252,2024,1715500,1253300,2968800,114939.0,,195225
R0112622,2024,847500,744700,1592200,56783.0,,102992
R0113847,2024,811800,719000,1530800,54391.0,,98879
R0114295,2024,2939200,1468400,4407600,196926.0,,291624
R0114299,2024,1224300,1538200,2762500,82028.0,,181403
R0114463,2024,280600,896700,1177300,15115.0,,75194
R0114665,2024,614500,686100,1300600,41172.0,,83455
R0115105,2024,587500,1237100,1824600,35677.0,,118563
R0115125,2024,1062500,752100,1814600,71188.0,,117893
R0115132,2024,1259000,1158400,2417400,84353.0,,158281
R0115136,2024,808400,656200,1464600,54163.0,,94443
R0115137,2024,848300,725900,1574200,56836.0,,101786
R0115138,2024,1066500,722800,1789300,71456.0,,116198
R0115292,2024,1409400,885300,2294700,94430.0,,150060
R0115293,2024,1287100,1003700,2290800,86236.0,,149799
R0115294,2024,955900,1052600,2008500,64045.0,,130885
R0115295,2024,876500,837000,1713500,58726.0,,111120
R0115296,2024,1106600,881100,1987700,74142.0,,129491
R0115297,2024,1194200,897100,2091300,80011.0,,136432
R0116531,2024,876000,566600,1442600,58692.0,,92969
R0117233,2024,2204800,1936900,4141700,147722.0,,273809
R0117617,2024,1308700,737500,2046200,87683.0,,133410
R0118472,2024,621600,779900,1401500,41647.0,,90216
R0120069,2024,449900,506000,955900,30143.0,,60360
R0120183,2024,473300,710800,1184100,31711.0,,75650
R0120855,2024,2080900,1557700,3638600,139420.0,,240101
R0121041,2024,456400,740900,1197300,30579.0,,76534
R0121407,2024,755800,550800,1306600,50639.0,,83857
R0121410,2024,734600,733900,1468500,49218.0,,94705
R0122555,2024,543400,646400,1189800,36408.0,,76032
R0123032,2024,371600,830400,1202000,21212.0,,76849
R0127035,2024,2236600,1252900,3489500,149852.0,,230112
R0127176,2024,649900,750100,1400000,39858.0,,90115
R0128246,2024,1888800,1120200,3009000,126550.0,,197918
R0128247,2024,2359300,1098500,3457800,158073.0,,227988
R0128248,2024,1767300,1225300,2992600,118409.0,,196819
R0128249,2024,1655000,1206800,2861800,110885.0,,188056
R0128911,2024,1477400,800100,2277500,98986.0,,148908
R0128912,2024,1425500,762000,2187500,95509.0,,142878
R0128913,2024,1333800,806200,2140000,89365.0,,139695
R0128914,2024,1470900,919800,2390700,98550.0,,156492
R0128918,2024,857400,811000,1668400,57446.0,,108098
R0129096,2024,853587,803300,1656887,57190.0,,107326
R0129355,2024,612800,709600,1322400,41058.0,,84916
R0130564,2024,409000,1053100,1462100,27403.0,,94276
R0144313,2024,293600,725100,1018700,19671.0,,64568
R0144315,2024,725100,882100,1607200,48582.0,,103997
R0146529,2024,1860200,1307900,3168100,124633.0,,208578
R0146852,2024,1782000,1304700,3086700,119394.0,,203124
R0148503,2024,1794000,1778400,3572400,120198.0,,235666
R0148504,2024,1827100,2004100,3831200,122416.0,,253005
R0149585,2024,660000,2410500,3070500,44220.0,,202039
R0500111,2024,590500,558700,1149200,39564.0,,73311
R0500530,2024,1316400,1262300,2578700,88198.0,,169088
R0501010,2024,278300,814000,1092300,18646.0,,69499
R0502125,2024,3262100,1512500,4774600,218561.0,,316213
R0502127,2024,1559000,1747600,3306600,104453.0,,217857
R0502226,2024,98860,889740,988600,6624.0,,62551
R0502227,2024,99460,895140,994600,6664.0,,62953
R0502233,2024,3141000,1583000,4724000,210447.0,,312823
R0502234,2024,2557900,1571200,4129100,171379.0,,272965
R0503066,2024,933000,1207200,2140200,62511.0,,139708
R0503067,2024,2011800,1528400,3540200,134790.0,,233508
R0503068,2024,1925700,1509700,3435400,125337.0,,226487
R0503545,2024,982100,2068400,3050500,65801.0,,200699
R0503546,2024,586500,2049400,2635900,39296.0,,172920
R0504613,2024,447800,1015400,1463200,26317.0,,94349
R0504990,2024,1049400,880900,1930300,70310.0,,125645
R0504991,2024,1044300,921200,1965500,69968.0,,128004
R0506951,2024,179290,1613610,1792900,12012.0,,116439
R0507372,2024,485200,986400,1471600,32508.0,,94912
R0507373,2024,577200,793100,1370300,38672.0,,88125
R0507784,2024,1462900,1458300,2921200,98014.0,,192035
R0508105,2024,911300,676700,1588000,61057.0,,102711
R0508106,2024,648500,834000,1482500,43450.0,,95643
R0508618,2024,0,3300000,3300000,,,217415
R0508632,2024,0,1550000,1550000,,,100165
R0510588,2024,598600,669700,1268300,40106.0,,81291
R0510912,2024,2944900,1185200,4130100,197308.0,,273032
R0510915,2024,939700,829200,1768900,62960.0,,114831
R0511052,2024,3115700,2480400,5596100,208752.0,,371254
R0511053,2024,344600,1130700,1475300,23088.0,,95160
R0511208,2024,539300,974400,1513700,36133.0,,97733
R0511524,2024,156230,1406070,1562300,10467.0,,100989
R0511580,2024,3060500,1378400,4438900,205054.0,,293721
R0511861,2024,3736300,1360900,5097200,246647.0,,337827
R0511862,2024,2925300,1313400,4238700,192310.0,,280308
R0512493,2024,1680000,1139700,2819700,112560.0,,185235
R0512494,2024,1840901,943500,2784401,123340.0,,182870
R0512497,2024,989300,1918800,2908100,66283.0,,191158
R0512690,2024,1926200,1256100,3182300,129055.0,,209529
R0512691,2024,801900,1597800,2399700,53728.0,,157095
R0513775,2024,1881900,2113700,3995600,122402.0,,264020
R0514263,2024,409300,822000,1231300,27423.0,,78812
R0514264,2024,150500,1015300,1165800,10083.0,,74424
R0514678,2024,1103300,948000,2051300,73921.0,,133752
R0515332,2024,2270900,949000,3219900,152150.0,,212048
R0515333,2024,1353400,1167500,2520900,90678.0,,165215
R0515586,2024,870200,845000,1715200,58303.0,,111233
R0515587,2024,450100,849300,1299400,30157.0,,83375
R0515700,2024,734200,840200,1574400,49191.0,,101800
R0515701,2024,855500,833800,1689300,57319.0,,109498
R0515853,2024,4676800,1341300,6018100,313346.0,,399528
R0515903,2024,2145200,1127900,3273100,143728.0,,215613
R0515904,2024,297000,1051700,1348700,19899.0,,86678
R0516365,2024,2644000,1461000,4105000,177148.0,,271350
R0600346,2024,224660,2021940,2246600,15052.0,,146837
R0600364,2024,1846500,1150700,2997200,123716.0,,197127
R0601620,2024,743700,3176500,3920200,49828.0,,258968
R0602125,2024,464000,707900,1171900,31088.0,,74832
R0602126,2024,583200,613200,1196400,39074.0,,76474
R0602132,2024,251050,2259450,2510500,16820.0,,164519
R0602170,2024,932200,1398200,2330400,58773.0,,152452
R0602171,2024,522200,1795400,2317600,34987.0,,151594
R0603119,2024,2563700,1673900,4237600,171768.0,,280234
R0603123,2024,1826800,1546200,3373000,122396.0,,222306
R0603888,2024,1507600,1224400,2732000,101009.0,,179359
R0603889,2024,151810,1366290,1518100,10171.0,,98028
R0605072,2024,2732000,2044600,4776600,183044.0,,316347
R0605073,2024,2889900,3192400,6082300,193623.0,,403829
R0605074,2024,2390600,1041700,3432300,160170.0,,226279
R0605075,2024,1481000,912000,2393000,99227.0,,156646
R0606035,2024,2773800,2157800,4931600,185845.0,,326732
R0606836,2024,2150100,1345900,3496000,144057.0,,230547
R0606837,2024,1942800,1413200,3356000,130168.0,,221167
R0607233,2024,0,764760,764760,0.0,,213368
R0607234,2024,296200,882600,1178800,19845.0,,75295
R0608223,2024,754200,872600,1626800,50531.0,,105311
R0608224,2024,661100,960100,1621200,44294.0,,104935
R0608952,2024,482600,691800,1174400,32334.0,,75000
R0610551,2024,1164500,1111100,2275600,78022.0,,148780
R0610552,2024,1572500,1002300,2574800,105358.0,,168827
R0610553,2024,1685900,986500,2672400,112955.0,,175366
R0612718,2024,695625,1108400,1804025,46607.0,,117185
R0613548,2024,329000,1110200,1439200,22043.0,,92741
R0613549,2024,565000,1159600,1724600,37855.0,,111863
R0616356,2024,98030,882270,980300,6568.0,,61995
R0616832,2024,280800,515000,795800,18814.0,,49634
